"";"ACCATG";"AACAAT";"TTAAAC";"CAAGAG";"ACCGTA";"score.global"
"GGGCGT";-10;2;-5;-8;-11;-32
"GGGCCT";-9;2;-5;-8;-10;-30
"GGGCGC";-11;-4;5;-9;-11;-30
"GGGTGT";-10;2;-5;-7;-10;-30
"GGGCCC";-10;-4;5;-9;-10;-28
"GGGCGA";-8;-3;-4;-6;-7;-28
"GGGTCT";-9;2;-5;-7;-9;-28
"GGGTGC";-11;-4;5;-8;-10;-28
"GGGCCA";-7;-3;-4;-6;-6;-26
"GGGTCC";-10;-4;5;-8;-9;-26
"GGGTGA";-8;-3;-4;-5;-6;-26
"GGTCGT";-8;4;-5;-8;-9;-26
"GGGCGG";-2;-5;-7;0;-11;-25
"GGGTCA";-7;-3;-4;-5;-5;-24
"GGTCCT";-7;4;-5;-8;-8;-24
"GGTCGC";-9;-2;5;-9;-9;-24
"GGTTGT";-8;4;-5;-7;-8;-24
"GGGCCG";-1;-5;-7;0;-10;-23
"GGGTGG";-2;-5;-7;1;-10;-23
"TGGCGT";-10;2;2;-6;-11;-23
"GGTCCC";-8;-2;5;-9;-8;-22
"GGTCGA";-6;-1;-4;-6;-5;-22
"GGTTCT";-7;4;-5;-7;-7;-22
"GGTTGC";-9;-2;5;-8;-8;-22
"GGGTCG";-1;-5;-7;1;-9;-21
"GTGCGT";-8;2;2;-8;-9;-21
"TGGCCT";-9;2;2;-6;-10;-21
"TGGCGC";-11;-4;12;-7;-11;-21
"TGGTGT";-10;2;2;-5;-10;-21
"GGTCCA";-5;-1;-4;-6;-4;-20
"GGTTCC";-8;-2;5;-8;-7;-20
"GGTTGA";-6;-1;-4;-5;-4;-20
"CGGCGT";-10;2;-4;4;-11;-19
"GGTCGG";0;-3;-7;0;-9;-19
"GTGCCT";-7;2;2;-8;-8;-19
"GTGCGC";-9;-4;12;-9;-9;-19
"GTGTGT";-8;2;2;-7;-8;-19
"TGGCCC";-10;-4;12;-7;-10;-19
"TGGCGA";-8;-3;3;-4;-7;-19
"TGGTCT";-9;2;2;-5;-9;-19
"TGGTGC";-11;-4;12;-6;-10;-19
"GGGCTT";-3;2;-5;-8;-4;-18
"GGTTCA";-5;-1;-4;-5;-3;-18
"CGGCCT";-9;2;-4;4;-10;-17
"CGGCGC";-11;-4;6;3;-11;-17
"CGGTGT";-10;2;-4;5;-10;-17
"GGTCCG";1;-3;-7;0;-8;-17
"GGTTGG";0;-3;-7;1;-8;-17
"GTGCCC";-8;-4;12;-9;-8;-17
"GTGCGA";-6;-3;3;-6;-5;-17
"GTGTCT";-7;2;2;-7;-7;-17
"GTGTGC";-9;-4;12;-8;-8;-17
"TGGCCA";-7;-3;3;-4;-6;-17
"TGGTCC";-10;-4;12;-6;-9;-17
"TGGTGA";-8;-3;3;-3;-6;-17
"TGTCGT";-8;4;2;-6;-9;-17
"GGGCAT";-8;6;-1;-4;-9;-16
"GGGCTC";-4;-4;5;-9;-4;-16
"GGGTTT";-3;2;-5;-7;-3;-16
"TGGCGG";-2;-5;0;2;-11;-16
"AGGCGT";-6;6;-3;-5;-7;-15
"CGGCCC";-10;-4;6;3;-10;-15
"CGGCGA";-8;-3;-3;6;-7;-15
"CGGTCT";-9;2;-4;5;-9;-15
"CGGTGC";-11;-4;6;4;-10;-15
"GAGCGT";-7;6;-3;-4;-7;-15
"GGACGT";-7;5;-1;-4;-8;-15
"GGTTCG";1;-3;-7;1;-7;-15
"GTGCCA";-5;-3;3;-6;-4;-15
"GTGTCC";-8;-4;12;-8;-7;-15
"GTGTGA";-6;-3;3;-5;-4;-15
"GTTCGT";-6;4;2;-8;-7;-15
"TGGTCA";-7;-3;3;-3;-5;-15
"TGTCCT";-7;4;2;-6;-8;-15
"TGTCGC";-9;-2;12;-7;-9;-15
"TGTTGT";-8;4;2;-5;-8;-15
"GAGCCT";-6;6;-3;-4;-7;-14
"GAGCGC";-8;0;7;-5;-8;-14
"GAGTGT";-7;6;-3;-3;-7;-14
"GGGAGT";-6;6;-1;-5;-8;-14
"GGGCAC";-9;0;9;-5;-9;-14
"GGGCTA";-1;-3;-4;-6;0;-14
"GGGGGT";-10;2;-5;1;-2;-14
"GGGTAT";-8;6;-1;-3;-8;-14
"GGGTTC";-4;-4;5;-8;-3;-14
"GTGCGG";0;-5;0;0;-9;-14
"TGGCCG";-1;-5;0;2;-10;-14
"TGGTGG";-2;-5;0;3;-10;-14
"AGGCCT";-5;6;-3;-5;-6;-13
"AGGCGC";-7;0;7;-6;-7;-13
"AGGTGT";-6;6;-3;-4;-6;-13
"CGGCCA";-7;-3;-3;6;-6;-13
"CGGTCC";-10;-4;6;4;-9;-13
"CGGTGA";-8;-3;-3;7;-6;-13
"CGTCGT";-8;4;-4;4;-9;-13
"GGACCT";-6;5;-1;-4;-7;-13
"GGACGC";-8;-1;9;-5;-8;-13
"GGATGT";-7;5;-1;-3;-7;-13
"GTGTCA";-5;-3;3;-5;-3;-13
"GTTCCT";-5;4;2;-8;-6;-13
"GTTCGC";-7;-2;12;-9;-7;-13
"GTTTGT";-6;4;2;-7;-6;-13
"TGTCCC";-8;-2;12;-7;-8;-13
"TGTCGA";-6;-1;3;-4;-5;-13
"TGTTCT";-7;4;2;-5;-7;-13
"TGTTGC";-9;-2;12;-6;-8;-13
"CGGCGG";-2;-5;-6;12;-11;-12
"GAGCCC";-7;0;7;-5;-7;-12
"GAGCGA";-5;1;-2;-2;-4;-12
"GAGTCT";-6;6;-3;-3;-6;-12
"GAGTGC";-8;0;7;-4;-7;-12
"GGGACT";-5;6;-1;-5;-7;-12
"GGGAGC";-7;0;9;-6;-8;-12
"GGGCAA";-6;1;0;-2;-5;-12
"GGGGCT";-9;2;-5;1;-1;-12
"GGGGGC";-11;-4;5;0;-2;-12
"GGGTAC";-9;0;9;-4;-8;-12
"GGGTTA";-1;-3;-4;-5;1;-12
"GGTCTT";-1;4;-5;-8;-2;-12
"GTGCCG";1;-5;0;0;-8;-12
"GTGTGG";0;-5;0;1;-8;-12
"TGGTCG";-1;-5;0;3;-9;-12
"TTGCGT";-8;2;9;-6;-9;-12
"AGGCCC";-6;0;7;-6;-6;-11
"AGGCGA";-4;1;-2;-3;-3;-11
"AGGTCT";-5;6;-3;-4;-5;-11
"AGGTGC";-7;0;7;-5;-6;-11
"CGGTCA";-7;-3;-3;7;-5;-11
"CGTCCT";-7;4;-4;4;-8;-11
"CGTCGC";-9;-2;6;3;-9;-11
"CGTTGT";-8;4;-4;5;-8;-11
"GGACCC";-7;-1;9;-5;-7;-11
"GGACGA";-5;0;0;-2;-4;-11
"GGATCT";-6;5;-1;-3;-6;-11
"GGATGC";-8;-1;9;-4;-7;-11
"GGGCTG";5;-5;-7;0;-4;-11
"GTTCCC";-6;-2;12;-9;-6;-11
"GTTCGA";-4;-1;3;-6;-3;-11
"GTTTCT";-5;4;2;-7;-5;-11
"GTTTGC";-7;-2;12;-8;-6;-11
"TGTCCA";-5;-1;3;-4;-4;-11
"TGTTCC";-8;-2;12;-6;-7;-11
"TGTTGA";-6;-1;3;-3;-4;-11
"CGGCCG";-1;-5;-6;12;-10;-10
"CGGTGG";-2;-5;-6;13;-10;-10
"GAGCCA";-4;1;-2;-2;-3;-10
"GAGTCC";-7;0;7;-4;-6;-10
"GAGTGA";-5;1;-2;-1;-3;-10
"GGGACC";-6;0;9;-6;-7;-10
"GGGAGA";-4;1;0;-3;-4;-10
"GGGGCC";-10;-4;5;0;-1;-10
"GGGGGA";-8;-3;-4;3;2;-10
"GGGTAA";-6;1;0;-1;-4;-10
"GGTCAT";-6;8;-1;-4;-7;-10
"GGTCTC";-2;-2;5;-9;-2;-10
"GGTTTT";-1;4;-5;-7;-1;-10
"GTGTCG";1;-5;0;1;-7;-10
"TGTCGG";0;-3;0;2;-9;-10
"TTGCCT";-7;2;9;-6;-8;-10
"TTGCGC";-9;-4;19;-7;-9;-10
"TTGTGT";-8;2;9;-5;-8;-10
"AGGCCA";-3;1;-2;-3;-2;-9
"AGGTCC";-6;0;7;-5;-5;-9
"AGGTGA";-4;1;-2;-2;-2;-9
"AGTCGT";-4;8;-3;-5;-5;-9
"CGTCCC";-8;-2;6;3;-8;-9
"CGTCGA";-6;-1;-3;6;-5;-9
"CGTTCT";-7;4;-4;5;-7;-9
"CGTTGC";-9;-2;6;4;-8;-9
"GAGCGG";1;-1;-5;4;-8;-9
"GATCGT";-5;8;-3;-4;-5;-9
"GGACCA";-4;0;0;-2;-3;-9
"GGATCC";-7;-1;9;-4;-6;-9
"GGATGA";-5;0;0;-1;-3;-9
"GGGCAG";0;-1;-3;4;-9;-9
"GGGTTG";5;-5;-7;1;-3;-9
"GTTCCA";-3;-1;3;-6;-2;-9
"GTTTCC";-6;-2;12;-8;-5;-9
"GTTTGA";-4;-1;3;-5;-2;-9
"TGGCTT";-3;2;2;-6;-4;-9
"TGTTCA";-5;-1;3;-3;-3;-9
"AGGCGG";2;-1;-5;3;-7;-8
"CGGTCG";-1;-5;-6;13;-9;-8
"CTGCGT";-8;2;3;4;-9;-8
"GAGTCA";-4;1;-2;-1;-2;-8
"GATCCT";-4;8;-3;-4;-5;-8
"GATCGC";-6;2;7;-5;-6;-8
"GATTGT";-5;8;-3;-3;-5;-8
"GGACGG";1;-2;-3;4;-8;-8
"GGGACA";-3;1;0;-3;-3;-8
"GGGGCA";-7;-3;-4;3;3;-8
"GGTAGT";-4;8;-1;-5;-6;-8
"GGTCAC";-7;2;9;-5;-7;-8
"GGTCTA";1;-1;-4;-6;2;-8
"GGTGGT";-8;4;-5;1;0;-8
"GGTTAT";-6;8;-1;-3;-6;-8
"GGTTTC";-2;-2;5;-8;-1;-8
"GTTCGG";2;-3;0;0;-7;-8
"TGTCCG";1;-3;0;2;-8;-8
"TGTTGG";0;-3;0;3;-8;-8
"TTGCCC";-8;-4;19;-7;-8;-8
"TTGCGA";-6;-3;10;-4;-5;-8
"TTGTCT";-7;2;9;-5;-7;-8
"TTGTGC";-9;-4;19;-6;-8;-8
"AGGTCA";-3;1;-2;-2;-1;-7
"AGTCCT";-3;8;-3;-5;-4;-7
"AGTCGC";-5;2;7;-6;-5;-7
"AGTTGT";-4;8;-3;-4;-4;-7
"CGTCCA";-5;-1;-3;6;-4;-7
"CGTTCC";-8;-2;6;4;-7;-7
"CGTTGA";-6;-1;-3;7;-4;-7
"GAGCCG";2;-1;-5;4;-7;-7
"GAGTGG";1;-1;-5;5;-7;-7
"GCGCGT";2;2;-4;-8;1;-7
"GGATCA";-4;0;0;-1;-2;-7
"GGGAGG";2;-1;-3;3;-8;-7
"GGGGGG";-2;-5;-7;9;-2;-7
"GGGTAG";0;-1;-3;5;-8;-7
"GTGCTT";-1;2;2;-8;-2;-7
"GTTTCA";-3;-1;3;-5;-1;-7
"TGGCAT";-8;6;6;-2;-9;-7
"TGGCTC";-4;-4;12;-7;-4;-7
"TGGTTT";-3;2;2;-5;-3;-7
"AGGCCG";3;-1;-5;3;-6;-6
"AGGTGG";2;-1;-5;4;-6;-6
"CGTCGG";0;-3;-6;12;-9;-6
"CTGCCT";-7;2;3;4;-8;-6
"CTGCGC";-9;-4;13;3;-9;-6
"CTGTGT";-8;2;3;5;-8;-6
"GATCCC";-5;2;7;-5;-5;-6
"GATCGA";-3;3;-2;-2;-2;-6
"GATTCT";-4;8;-3;-3;-4;-6
"GATTGC";-6;2;7;-4;-5;-6
"GGACCG";2;-2;-3;4;-7;-6
"GGATGG";1;-2;-3;5;-7;-6
"GGTACT";-3;8;-1;-5;-5;-6
"GGTAGC";-5;2;9;-6;-6;-6
"GGTCAA";-4;3;0;-2;-3;-6
"GGTGCT";-7;4;-5;1;1;-6
"GGTGGC";-9;-2;5;0;0;-6
"GGTTAC";-7;2;9;-4;-6;-6
"GGTTTA";1;-1;-4;-5;3;-6
"GTTCCG";3;-3;0;0;-6;-6
"GTTTGG";2;-3;0;1;-6;-6
"TAGCGT";-7;6;4;-2;-7;-6
"TGACGT";-7;5;6;-2;-8;-6
"TGTTCG";1;-3;0;3;-7;-6
"TTGCCA";-5;-3;10;-4;-4;-6
"TTGTCC";-8;-4;19;-6;-7;-6
"TTGTGA";-6;-3;10;-3;-4;-6
"TTTCGT";-6;4;9;-6;-7;-6
"AGTCCC";-4;2;7;-6;-4;-5
"AGTCGA";-2;3;-2;-3;-1;-5
"AGTTCT";-3;8;-3;-4;-3;-5
"AGTTGC";-5;2;7;-5;-4;-5
"CGGCTT";-3;2;-4;4;-4;-5
"CGTTCA";-5;-1;-3;7;-3;-5
"GAGTCG";2;-1;-5;5;-6;-5
"GCGCCT";3;2;-4;-8;2;-5
"GCGCGC";1;-4;6;-9;1;-5
"GCGTGT";2;2;-4;-7;2;-5
"GGGACG";3;-1;-3;3;-7;-5
"GGGGCG";-1;-5;-7;9;-1;-5
"GGTCTG";7;-3;-7;0;-2;-5
"GTGCAT";-6;6;6;-4;-7;-5
"GTGCTC";-2;-4;12;-9;-2;-5
"GTGTTT";-1;2;2;-7;-1;-5
"TAGCCT";-6;6;4;-2;-7;-5
"TAGCGC";-8;0;14;-3;-8;-5
"TAGTGT";-7;6;4;-1;-7;-5
"TGGAGT";-6;6;6;-3;-8;-5
"TGGCAC";-9;0;16;-3;-9;-5
"TGGCTA";-1;-3;3;-4;0;-5
"TGGGGT";-10;2;2;3;-2;-5
"TGGTAT";-8;6;6;-1;-8;-5
"TGGTTC";-4;-4;12;-6;-3;-5
"TTGCGG";0;-5;7;2;-9;-5
"AGGTCG";3;-1;-5;4;-5;-4
"ATGCGT";-4;6;4;-5;-5;-4
"CGTCCG";1;-3;-6;12;-8;-4
"CGTTGG";0;-3;-6;13;-8;-4
"CTGCCC";-8;-4;13;3;-8;-4
"CTGCGA";-6;-3;4;6;-5;-4
"CTGTCT";-7;2;3;5;-7;-4
"CTGTGC";-9;-4;13;4;-8;-4
"GATCCA";-2;3;-2;-2;-1;-4
"GATTCC";-5;2;7;-4;-4;-4
"GATTGA";-3;3;-2;-1;-1;-4
"GGATCG";2;-2;-3;5;-6;-4
"GGTACC";-4;2;9;-6;-5;-4
"GGTAGA";-2;3;0;-3;-2;-4
"GGTGCC";-8;-2;5;0;1;-4
"GGTGGA";-6;-1;-4;3;4;-4
"GGTTAA";-4;3;0;-1;-2;-4
"GTACGT";-5;5;6;-4;-6;-4
"GTTTCG";3;-3;0;1;-5;-4
"TGACCT";-6;5;6;-2;-7;-4
"TGACGC";-8;-1;16;-3;-8;-4
"TGATGT";-7;5;6;-1;-7;-4
"TTGTCA";-5;-3;10;-3;-3;-4
"TTTCCT";-5;4;9;-6;-6;-4
"TTTCGC";-7;-2;19;-7;-7;-4
"TTTTGT";-6;4;9;-5;-6;-4
"AGTCCA";-1;3;-2;-3;0;-3
"AGTTCC";-4;2;7;-5;-3;-3
"AGTTGA";-2;3;-2;-2;0;-3
"CGGCAT";-8;6;0;8;-9;-3
"CGGCTC";-4;-4;6;3;-4;-3
"CGGTTT";-3;2;-4;5;-3;-3
"GATCGG";3;1;-5;4;-6;-3
"GCGCCC";2;-4;6;-9;2;-3
"GCGCGA";4;-3;-3;-6;5;-3
"GCGTCT";3;2;-4;-7;3;-3
"GCGTGC";1;-4;6;-8;2;-3
"GGTCAG";2;1;-3;4;-7;-3
"GGTTTG";7;-3;-7;1;-1;-3
"GTGAGT";-4;6;6;-5;-6;-3
"GTGCAC";-7;0;16;-5;-7;-3
"GTGCTA";1;-3;3;-6;2;-3
"GTGGGT";-8;2;2;1;0;-3
"GTGTAT";-6;6;6;-3;-6;-3
"GTGTTC";-2;-4;12;-8;-1;-3
"TAGCCC";-7;0;14;-3;-7;-3
"TAGCGA";-5;1;5;0;-4;-3
"TAGTCT";-6;6;4;-1;-6;-3
"TAGTGC";-8;0;14;-2;-7;-3
"TGGACT";-5;6;6;-3;-7;-3
"TGGAGC";-7;0;16;-4;-8;-3
"TGGCAA";-6;1;7;0;-5;-3
"TGGGCT";-9;2;2;3;-1;-3
"TGGGGC";-11;-4;12;2;-2;-3
"TGGTAC";-9;0;16;-2;-8;-3
"TGGTTA";-1;-3;3;-3;1;-3
"TGTCTT";-1;4;2;-6;-2;-3
"TTGCCG";1;-5;7;2;-8;-3
"TTGTGG";0;-5;7;3;-8;-3
"AGTCGG";4;1;-5;3;-5;-2
"ATGCCT";-3;6;4;-5;-4;-2
"ATGCGC";-5;0;14;-6;-5;-2
"ATGTGT";-4;6;4;-4;-4;-2
"CAGCGT";-7;6;-2;8;-7;-2
"CGACGT";-7;5;0;8;-8;-2
"CGTTCG";1;-3;-6;13;-7;-2
"CTGCCA";-5;-3;4;6;-4;-2
"CTGTCC";-8;-4;13;4;-7;-2
"CTGTGA";-6;-3;4;7;-4;-2
"CTTCGT";-6;4;3;4;-7;-2
"GAGCTT";0;6;-3;-4;-1;-2
"GATTCA";-2;3;-2;-1;0;-2
"GGTACA";-1;3;0;-3;-1;-2
"GGTGCA";-5;-1;-4;3;5;-2
"GTACCT";-4;5;6;-4;-5;-2
"GTACGC";-6;-1;16;-5;-6;-2
"GTATGT";-5;5;6;-3;-5;-2
"TGACCC";-7;-1;16;-3;-7;-2
"TGACGA";-5;0;7;0;-4;-2
"TGATCT";-6;5;6;-1;-6;-2
"TGATGC";-8;-1;16;-2;-7;-2
"TGGCTG";5;-5;0;2;-4;-2
"TTTCCC";-6;-2;19;-7;-6;-2
"TTTCGA";-4;-1;10;-4;-3;-2
"TTTTCT";-5;4;9;-5;-5;-2
"TTTTGC";-7;-2;19;-6;-6;-2
"AGGCTT";1;6;-3;-5;0;-1
"AGTTCA";-1;3;-2;-2;1;-1
"CAGCCT";-6;6;-2;8;-7;-1
"CAGCGC";-8;0;8;7;-8;-1
"CAGTGT";-7;6;-2;9;-7;-1
"CGGAGT";-6;6;0;7;-8;-1
"CGGCAC";-9;0;10;7;-9;-1
"CGGCTA";-1;-3;-3;6;0;-1
"CGGGGT";-10;2;-4;13;-2;-1
"CGGTTC";-4;-4;6;4;-3;-1
"CTGCGG";0;-5;1;12;-9;-1
"GATCCG";4;1;-5;4;-5;-1
"GATTGG";3;1;-5;5;-5;-1
"GCGCCA";5;-3;-3;-6;6;-1
"GCGTCC";2;-4;6;-8;3;-1
"GCGTGA";4;-3;-3;-5;6;-1
"GCTCGT";4;4;-4;-8;3;-1
"GGACTT";0;5;-1;-4;-1;-1
"GGTAGG";4;1;-3;3;-6;-1
"GGTGGG";0;-3;-7;9;0;-1
"GGTTAG";2;1;-3;5;-6;-1
"GTGACT";-3;6;6;-5;-5;-1
"GTGAGC";-5;0;16;-6;-6;-1
"GTGCAA";-4;1;7;-2;-3;-1
"GTGGCT";-7;2;2;1;1;-1
"GTGGGC";-9;-4;12;0;0;-1
"GTGTAC";-7;0;16;-4;-6;-1
"GTGTTA";1;-3;3;-5;3;-1
"GTTCTT";1;4;2;-8;0;-1
"TAGCCA";-4;1;5;0;-3;-1
"TAGTCC";-7;0;14;-2;-6;-1
"TAGTGA";-5;1;5;1;-3;-1
"TGGACC";-6;0;16;-4;-7;-1
"TGGAGA";-4;1;7;-1;-4;-1
"TGGGCC";-10;-4;12;2;-1;-1
"TGGGGA";-8;-3;3;5;2;-1
"TGGTAA";-6;1;7;1;-4;-1
"TGTCAT";-6;8;6;-2;-7;-1
"TGTCTC";-2;-2;12;-7;-2;-1
"TGTTTT";-1;4;2;-5;-1;-1
"TTGTCG";1;-5;7;3;-7;-1
"AGTCCG";5;1;-5;3;-4;0
"AGTTGG";4;1;-5;4;-4;0
"ATGCCC";-4;0;14;-6;-4;0
"ATGCGA";-2;1;5;-3;-1;0
"ATGTCT";-3;6;4;-4;-3;0
"ATGTGC";-5;0;14;-5;-4;0
"CGACCT";-6;5;0;8;-7;0
"CGACGC";-8;-1;10;7;-8;0
"CGATGT";-7;5;0;9;-7;0
"CGGTAT";-8;6;0;9;-7;0
"CTGTCA";-5;-3;4;7;-3;0
"CTTCCT";-5;4;3;4;-6;0
"CTTCGC";-7;-2;13;3;-7;0
"CTTTGT";-6;4;3;5;-6;0
"GAGCAT";-5;10;1;0;-6;0
"GAGCTC";-1;0;7;-5;-1;0
"GAGTTT";0;6;-3;-3;0;0
"GCGCGG";10;-5;-6;0;1;0
"GGGATT";1;6;-1;-5;-1;0
"GGGGTT";-3;2;-5;1;5;0
"GTACCC";-5;-1;16;-5;-5;0
"GTACGA";-3;0;7;-2;-2;0
"GTATCT";-4;5;6;-3;-4;0
"GTATGC";-6;-1;16;-4;-5;0
"GTGCTG";7;-5;0;0;-2;0
"TAGCGG";1;-1;2;6;-8;0
"TATCGT";-5;8;4;-2;-5;0
"TGACCA";-4;0;7;0;-3;0
"TGATCC";-7;-1;16;-2;-6;0
"TGATGA";-5;0;7;1;-3;0
"TGGCAG";0;-1;4;6;-9;0
"TGGTTG";5;-5;0;3;-3;0
"TTTCCA";-3;-1;10;-4;-2;0
"TTTTCC";-6;-2;19;-6;-5;0
"TTTTGA";-4;-1;10;-3;-2;0
"AAGCGT";-3;10;-1;-1;-4;1
"AGGCAT";-4;10;1;-1;-5;1
"AGGCTC";0;0;7;-6;0;1
"AGGTTT";1;6;-3;-4;1;1
"CAGCCC";-7;0;8;7;-7;1
"CAGCGA";-5;1;-1;10;-4;1
"CAGTCT";-6;6;-2;9;-6;1
"CAGTGC";-8;0;8;8;-7;1
"CGGACT";-5;6;0;7;-7;1
"CGGAGC";-7;0;10;6;-8;1
"CGGCAA";-6;1;1;10;-5;1
"CGGGCT";-9;2;-4;13;-1;1
"CGGGGC";-11;-4;6;12;-2;1
"CGGTTA";-1;-3;-3;7;1;1
"CGTCTT";-1;4;-4;4;-2;1
"CTGCCG";1;-5;1;12;-8;1
"CTGTGG";0;-5;1;13;-8;1
"GATTCG";4;1;-5;5;-4;1
"GCGTCA";5;-3;-3;-5;7;1
"GCTCCT";5;4;-4;-8;4;1
"GCTCGC";3;-2;6;-9;3;1
"GCTTGT";4;4;-4;-7;4;1
"GGACAT";-5;9;3;0;-6;1
"GGACTC";-1;-1;9;-5;-1;1
"GGATTT";0;5;-1;-3;0;1
"GGTACG";5;1;-3;3;-5;1
"GGTGCG";1;-3;-7;9;1;1
"GTGACC";-4;0;16;-6;-5;1
"GTGAGA";-2;1;7;-3;-2;1
"GTGGCC";-8;-4;12;0;1;1
"GTGGGA";-6;-3;3;3;4;1
"GTGTAA";-4;1;7;-1;-2;1
"GTTCAT";-4;8;6;-4;-5;1
"GTTCTC";0;-2;12;-9;0;1
"GTTTTT";1;4;2;-7;1;1
"TAGTCA";-4;1;5;1;-2;1
"TATCCT";-4;8;4;-2;-5;1
"TATCGC";-6;2;14;-3;-6;1
"TATTGT";-5;8;4;-1;-5;1
"TGACGG";1;-2;4;6;-8;1
"TGGACA";-3;1;7;-1;-3;1
"TGGGCA";-7;-3;3;5;3;1
"TGTAGT";-4;8;6;-3;-6;1
"TGTCAC";-7;2;16;-3;-7;1
"TGTCTA";1;-1;3;-4;2;1
"TGTGGT";-8;4;2;3;0;1
"TGTTAT";-6;8;6;-1;-6;1
"TGTTTC";-2;-2;12;-6;-1;1
"TTTCGG";2;-3;7;2;-7;1
"AGACGT";-3;9;1;-1;-4;2
"AGTTCG";5;1;-5;4;-3;2
"ATGCCA";-1;1;5;-3;0;2
"ATGTCC";-4;0;14;-5;-3;2
"ATGTGA";-2;1;5;-2;0;2
"ATTCGT";-2;8;4;-5;-3;2
"CGACCC";-7;-1;10;7;-7;2
"CGACGA";-5;0;1;10;-4;2
"CGATCT";-6;5;0;9;-6;2
"CGGCTG";5;-5;-6;12;-4;2
"CGGTAC";-9;0;10;8;-7;2
"CTTCCC";-6;-2;13;3;-6;2
"CTTCGA";-4;-1;4;6;-3;2
"CTTTCT";-5;4;3;5;-5;2
"CTTTGC";-7;-2;13;4;-6;2
"GAACGT";-4;9;1;0;-4;2
"GAGAGT";-3;10;1;-1;-5;2
"GAGCAC";-6;4;11;-1;-6;2
"GAGCTA";2;1;-2;-2;3;2
"GAGGGT";-7;6;-3;5;1;2
"GAGTAT";-5;10;1;1;-5;2
"GAGTTC";-1;0;7;-4;0;2
"GCGCCG";11;-5;-6;0;2;2
"GCGTGG";10;-5;-6;1;2;2
"GGGAAT";-4;10;3;-1;-6;2
"GGGATC";0;0;9;-6;-1;2
"GGGGAT";-8;6;-1;5;0;2
"GGGGTC";-4;-4;5;0;5;2
"GTACCA";-2;0;7;-2;-1;2
"GTATCC";-5;-1;16;-4;-4;2
"GTATGA";-3;0;7;-1;-1;2
"GTGCAG";2;-1;4;4;-7;2
"GTGTTG";7;-5;0;1;-1;2
"TAGCCG";2;-1;2;6;-7;2
"TAGTGG";1;-1;2;7;-7;2
"TCGCGT";2;2;3;-6;1;2
"TGATCA";-4;0;7;1;-2;2
"TGGAGG";2;-1;4;5;-8;2
"TGGGGG";-2;-5;0;11;-2;2
"TGGTAG";0;-1;4;7;-8;2
"TTGCTT";-1;2;9;-6;-2;2
"TTTTCA";-3;-1;10;-3;-1;2
"AAGCCT";-2;10;-1;-1;-3;3
"AAGCGC";-4;4;9;-2;-4;3
"AAGTGT";-3;10;-1;0;-3;3
"AGGAGT";-2;10;1;-2;-4;3
"AGGCAC";-5;4;11;-2;-5;3
"AGGCTA";3;1;-2;-3;4;3
"AGGGGT";-6;6;-3;4;2;3
"AGGTAT";-4;10;1;0;-4;3
"AGGTTC";0;0;7;-5;1;3
"ATGCGG";4;-1;2;3;-5;3
"CAGCCA";-4;1;-1;10;-3;3
"CAGTCC";-7;0;8;8;-6;3
"CAGTGA";-5;1;-1;11;-3;3
"CGATGC";-7;-1;10;8;-7;3
"CGGACC";-6;0;10;6;-7;3
"CGGAGA";-4;1;1;9;-4;3
"CGGGCC";-10;-4;6;12;-1;3
"CGGGGA";-8;-3;-3;15;2;3
"CGGTAA";-6;1;1;11;-4;3
"CGTCAT";-6;8;0;8;-7;3
"CGTCTC";-2;-2;6;3;-2;3
"CGTTTT";-1;4;-4;5;-1;3
"CTGTCG";1;-5;1;13;-7;3
"GAACCT";-3;9;1;0;-4;3
"GAACGC";-5;3;11;-1;-5;3
"GAATGT";-4;9;1;1;-4;3
"GCTCCC";4;-2;6;-9;4;3
"GCTCGA";6;-1;-3;-6;7;3
"GCTTCT";5;4;-4;-7;5;3
"GCTTGC";3;-2;6;-8;4;3
"GGAAGT";-3;9;3;-1;-5;3
"GGACAC";-6;3;13;-1;-6;3
"GGACTA";2;0;0;-2;3;3
"GGAGGT";-7;5;-1;5;1;3
"GGATAT";-5;9;3;1;-5;3
"GGATTC";-1;-1;9;-4;0;3
"GTACGG";3;-2;4;4;-6;3
"GTGACA";-1;1;7;-3;-1;3
"GTGGCA";-5;-3;3;3;5;3
"GTTAGT";-2;8;6;-5;-4;3
"GTTCAC";-5;2;16;-5;-5;3
"GTTCTA";3;-1;3;-6;4;3
"GTTGGT";-6;4;2;1;2;3
"GTTTAT";-4;8;6;-3;-4;3
"GTTTTC";0;-2;12;-8;1;3
"TATCCC";-5;2;14;-3;-5;3
"TATCGA";-3;3;5;0;-2;3
"TATTCT";-4;8;4;-1;-4;3
"TATTGC";-6;2;14;-2;-5;3
"TGACCG";2;-2;4;6;-7;3
"TGATGG";1;-2;4;7;-7;3
"TGTACT";-3;8;6;-3;-5;3
"TGTAGC";-5;2;16;-4;-6;3
"TGTCAA";-4;3;7;0;-3;3
"TGTGCT";-7;4;2;3;1;3
"TGTGGC";-9;-2;12;2;0;3
"TGTTAC";-7;2;16;-2;-6;3
"TGTTTA";1;-1;3;-3;3;3
"TTTCCG";3;-3;7;2;-6;3
"TTTTGG";2;-3;7;3;-6;3
"AGACCT";-2;9;1;-1;-3;4
"AGACGC";-4;3;11;-2;-4;4
"AGATGT";-3;9;1;0;-3;4
"ATGTCA";-1;1;5;-2;1;4
"ATTCCT";-1;8;4;-5;-2;4
"ATTCGC";-3;2;14;-6;-3;4
"ATTTGT";-2;8;4;-4;-2;4
"CAGCGG";1;-1;-4;16;-8;4
"CATCGT";-5;8;-2;8;-5;4
"CGACCA";-4;0;1;10;-3;4
"CGATCC";-7;-1;10;8;-6;4
"CGATGA";-5;0;1;11;-3;4
"CGGCAG";0;-1;-2;16;-9;4
"CGGTTG";5;-5;-6;13;-3;4
"CTTCCA";-3;-1;4;6;-2;4
"CTTTCC";-6;-2;13;4;-5;4
"CTTTGA";-4;-1;4;7;-2;4
"GAGACT";-2;10;1;-1;-4;4
"GAGAGC";-4;4;11;-2;-5;4
"GAGCAA";-3;5;2;2;-2;4
"GAGGCT";-6;6;-3;5;2;4
"GAGGGC";-8;0;7;4;1;4
"GAGTAC";-6;4;11;0;-5;4
"GAGTTA";2;1;-2;-1;4;4
"GATCTT";2;8;-3;-4;1;4
"GCGTCG";11;-5;-6;1;3;4
"GGCCGT";2;14;-5;-8;1;4
"GGGAAC";-5;4;13;-2;-6;4
"GGGATA";3;1;0;-3;3;4
"GGGGAC";-9;0;9;4;0;4
"GGGGTA";-1;-3;-4;3;9;4
"GTATCA";-2;0;7;-1;0;4
"GTGAGG";4;-1;4;3;-6;4
"GTGGGG";0;-5;0;9;0;4
"GTGTAG";2;-1;4;5;-6;4
"TAGTCG";2;-1;2;7;-6;4
"TCGCCT";3;2;3;-6;2;4
"TCGCGC";1;-4;13;-7;1;4
"TCGTGT";2;2;3;-5;2;4
"TGGACG";3;-1;4;5;-7;4
"TGGGCG";-1;-5;0;11;-1;4
"TGTCTG";7;-3;0;2;-2;4
"TTGCAT";-6;6;13;-2;-7;4
"TTGCTC";-2;-4;19;-7;-2;4
"TTGTTT";-1;2;9;-5;-1;4
"AAGCCC";-3;4;9;-2;-3;5
"AAGCGA";-1;5;0;1;0;5
"AAGTCT";-2;10;-1;0;-2;5
"AAGTGC";-4;4;9;-1;-3;5
"AGGACT";-1;10;1;-2;-3;5
"AGGAGC";-3;4;11;-3;-4;5
"AGGCAA";-2;5;2;1;-1;5
"AGGGCT";-5;6;-3;4;3;5
"AGGGGC";-7;0;7;3;2;5
"AGGTAC";-5;4;11;-1;-4;5
"AGGTTA";3;1;-2;-2;5;5
"AGTCTT";3;8;-3;-5;2;5
"ATGCCG";5;-1;2;3;-4;5
"ATGTGG";4;-1;2;4;-4;5
"CAGTCA";-4;1;-1;11;-2;5
"CATCCT";-4;8;-2;8;-5;5
"CATCGC";-6;2;8;7;-6;5
"CATTGT";-5;8;-2;9;-5;5
"CGACGG";1;-2;-2;16;-8;5
"CGGACA";-3;1;1;9;-3;5
"CGGGCA";-7;-3;-3;15;3;5
"CGTAGT";-4;8;0;7;-6;5
"CGTCAC";-7;2;10;7;-7;5
"CGTCTA";1;-1;-3;6;2;5
"CGTGGT";-8;4;-4;13;0;5
"CGTTAT";-6;8;0;9;-6;5
"CGTTTC";-2;-2;6;4;-1;5
"CTTCGG";2;-3;1;12;-7;5
"GAACCC";-4;3;11;-1;-4;5
"GAACGA";-2;4;2;2;-1;5
"GAATCT";-3;9;1;1;-3;5
"GAATGC";-5;3;11;0;-4;5
"GAGCTG";8;-1;-5;4;-1;5
"GCTCCA";7;-1;-3;-6;8;5
"GCTTCC";4;-2;6;-8;5;5
"GCTTGA";6;-1;-3;-5;8;5
"GGAACT";-2;9;3;-1;-4;5
"GGAAGC";-4;3;13;-2;-5;5
"GGACAA";-3;4;4;2;-2;5
"GGAGCT";-6;5;-1;5;2;5
"GGAGGC";-8;-1;9;4;1;5
"GGATAC";-6;3;13;0;-5;5
"GGATTA";2;0;0;-1;4;5
"GTACCG";4;-2;4;4;-5;5
"GTATGG";3;-2;4;5;-5;5
"GTTACT";-1;8;6;-5;-3;5
"GTTAGC";-3;2;16;-6;-4;5
"GTTCAA";-2;3;7;-2;-1;5
"GTTGCT";-5;4;2;1;3;5
"GTTGGC";-7;-2;12;0;2;5
"GTTTAC";-5;2;16;-4;-4;5
"GTTTTA";3;-1;3;-5;5;5
"TATCCA";-2;3;5;0;-1;5
"TATTCC";-5;2;14;-2;-4;5
"TATTGA";-3;3;5;1;-1;5
"TGATCG";2;-2;4;7;-6;5
"TGTACC";-4;2;16;-4;-5;5
"TGTAGA";-2;3;7;-1;-2;5
"TGTGCC";-8;-2;12;2;1;5
"TGTGGA";-6;-1;3;5;4;5
"TGTTAA";-4;3;7;1;-2;5
"TTACGT";-5;5;13;-2;-6;5
"TTTTCG";3;-3;7;3;-5;5
"AGACCC";-3;3;11;-2;-3;6
"AGACGA";-1;4;2;1;0;6
"AGATCT";-2;9;1;0;-2;6
"AGATGC";-4;3;11;-1;-3;6
"AGGCTG";9;-1;-5;3;0;6
"ATTCCC";-2;2;14;-6;-2;6
"ATTCGA";0;3;5;-3;1;6
"ATTTCT";-1;8;4;-4;-1;6
"ATTTGC";-3;2;14;-5;-2;6
"CAGCCG";2;-1;-4;16;-7;6
"CAGTGG";1;-1;-4;17;-7;6
"CCGCGT";2;2;-3;4;1;6
"CGATCA";-4;0;1;11;-2;6
"CGGAGG";2;-1;-2;15;-8;6
"CGGGGG";-2;-5;-6;21;-2;6
"CTGCTT";-1;2;3;4;-2;6
"CTTTCA";-3;-1;4;7;-1;6
"GAGACC";-3;4;11;-2;-4;6
"GAGAGA";-1;5;2;1;-1;6
"GAGGCC";-7;0;7;4;2;6
"GAGGGA";-5;1;-2;7;5;6
"GAGTAA";-3;5;2;3;-1;6
"GATCAT";-3;12;1;0;-4;6
"GATCTC";1;2;7;-5;1;6
"GATTTT";2;8;-3;-3;2;6
"GCTCGG";12;-3;-6;0;3;6
"GGACTG";8;-2;-3;4;-1;6
"GGCCCT";3;14;-5;-8;2;6
"GGCCGC";1;8;5;-9;1;6
"GGCTGT";2;14;-5;-7;2;6
"GGGAAA";-2;5;4;1;-2;6
"GGGGAA";-6;1;0;7;4;6
"GGTATT";3;8;-1;-5;1;6
"GGTGTT";-1;4;-5;1;7;6
"GTGACG";5;-1;4;3;-5;6
"GTGGCG";1;-5;0;9;1;6
"GTTCTG";9;-3;0;0;0;6
"TATCGG";3;1;2;6;-6;6
"TCGCCC";2;-4;13;-7;2;6
"TCGCGA";4;-3;4;-4;5;6
"TCGTCT";3;2;3;-5;3;6
"TCGTGC";1;-4;13;-6;2;6
"TGTCAG";2;1;4;6;-7;6
"TGTTTG";7;-3;0;3;-1;6
"TTGAGT";-4;6;13;-3;-6;6
"TTGCAC";-7;0;23;-3;-7;6
"TTGCTA";1;-3;10;-4;2;6
"TTGGGT";-8;2;9;3;0;6
"TTGTAT";-6;6;13;-1;-6;6
"TTGTTC";-2;-4;19;-6;-1;6
"AAGCCA";0;5;0;1;1;7
"AAGTCC";-3;4;9;-1;-2;7
"AAGTGA";-1;5;0;2;1;7
"AATCGT";-1;12;-1;-1;-2;7
"AGGACC";-2;4;11;-3;-3;7
"AGGAGA";0;5;2;0;0;7
"AGGGCC";-6;0;7;3;3;7
"AGGGGA";-4;1;-2;6;6;7
"AGGTAA";-2;5;2;2;0;7
"AGTCAT";-2;12;1;-1;-3;7
"AGTCTC";2;2;7;-6;2;7
"AGTTTT";3;8;-3;-4;3;7
"ATGTCG";5;-1;2;4;-3;7
"CATCCC";-5;2;8;7;-5;7
"CATCGA";-3;3;-1;10;-2;7
"CATTCT";-4;8;-2;9;-4;7
"CATTGC";-6;2;8;8;-5;7
"CGACCG";2;-2;-2;16;-7;7
"CGATGG";1;-2;-2;17;-7;7
"CGGTAG";0;-1;-2;17;-7;7
"CGTACT";-3;8;0;7;-5;7
"CGTAGC";-5;2;10;6;-6;7
"CGTCAA";-4;3;1;10;-3;7
"CGTGCT";-7;4;-4;13;1;7
"CGTGGC";-9;-2;6;12;0;7
"CGTTAC";-7;2;10;8;-6;7
"CGTTTA";1;-1;-3;7;3;7
"CTTCCG";3;-3;1;12;-6;7
"CTTTGG";2;-3;1;13;-6;7
"GAACCA";-1;4;2;2;0;7
"GAATCC";-4;3;11;0;-3;7
"GAATGA";-2;4;2;3;0;7
"GAGCAG";3;3;-1;8;-6;7
"GAGTTG";8;-1;-5;5;0;7
"GCGCTT";9;2;-4;-8;8;7
"GCTTCA";7;-1;-3;-5;9;7
"GGAACC";-3;3;13;-2;-4;7
"GGAAGA";-1;4;4;1;-1;7
"GGAGCC";-7;-1;9;4;2;7
"GGAGGA";-5;0;0;7;5;7
"GGATAA";-3;4;4;3;-1;7
"GGGATG";9;-1;-3;3;-1;7
"GGGGTG";5;-5;-7;9;5;7
"GTATCG";4;-2;4;5;-4;7
"GTTACC";-2;2;16;-6;-3;7
"GTTAGA";0;3;7;-3;0;7
"GTTGCC";-6;-2;12;0;3;7
"GTTGGA";-4;-1;3;3;6;7
"GTTTAA";-2;3;7;-1;0;7
"TAGCTT";0;6;4;-2;-1;7
"TATTCA";-2;3;5;1;0;7
"TGTACA";-1;3;7;-1;-1;7
"TGTGCA";-5;-1;3;5;5;7
"TTACCT";-4;5;13;-2;-5;7
"TTACGC";-6;-1;23;-3;-6;7
"TTATGT";-5;5;13;-1;-5;7
"AAGCGG";5;3;-3;7;-4;8
"AGACCA";0;4;2;1;1;8
"AGATCC";-3;3;11;-1;-2;8
"AGATGA";-1;4;2;2;1;8
"AGGCAG";4;3;-1;7;-5;8
"AGGTTG";9;-1;-5;4;1;8
"ATTCCA";1;3;5;-3;2;8
"ATTTCC";-2;2;14;-5;-1;8
"ATTTGA";0;3;5;-2;2;8
"CAGTCG";2;-1;-4;17;-6;8
"CCGCCT";3;2;-3;4;2;8
"CCGCGC";1;-4;7;3;1;8
"CCGTGT";2;2;-3;5;2;8
"CGGACG";3;-1;-2;15;-7;8
"CGGGCG";-1;-5;-6;21;-1;8
"CGTCTG";7;-3;-6;12;-2;8
"CTGCAT";-6;6;7;8;-7;8
"CTGCTC";-2;-4;13;3;-2;8
"CTGTTT";-1;2;3;5;-1;8
"GAACGG";4;2;-1;8;-5;8
"GAGACA";0;5;2;1;0;8
"GAGGCA";-4;1;-2;7;6;8
"GATAGT";-1;12;1;-1;-3;8
"GATCAC";-4;6;11;-1;-4;8
"GATCTA";4;3;-2;-2;5;8
"GATGGT";-5;8;-3;5;3;8
"GATTAT";-3;12;1;1;-3;8
"GATTTC";1;2;7;-4;2;8
"GCTCCG";13;-3;-6;0;4;8
"GCTTGG";12;-3;-6;1;4;8
"GGACAG";3;2;1;8;-6;8
"GGATTG";8;-2;-3;5;0;8
"GGCCCC";2;8;5;-9;2;8
"GGCCGA";4;9;-4;-6;5;8
"GGCTCT";3;14;-5;-7;3;8
"GGCTGC";1;8;5;-8;2;8
"GGTAAT";-2;12;3;-1;-4;8
"GGTATC";2;2;9;-6;1;8
"GGTGAT";-6;8;-1;5;2;8
"GGTGTC";-2;-2;5;0;7;8
"GTTCAG";4;1;4;4;-5;8
"GTTTTG";9;-3;0;1;1;8
"TATCCG";4;1;2;6;-5;8
"TATTGG";3;1;2;7;-5;8
"TCGCCA";5;-3;4;-4;6;8
"TCGTCC";2;-4;13;-6;3;8
"TCGTGA";4;-3;4;-3;6;8
"TCTCGT";4;4;3;-6;3;8
"TGACTT";0;5;6;-2;-1;8
"TGTAGG";4;1;4;5;-6;8
"TGTGGG";0;-3;0;11;0;8
"TGTTAG";2;1;4;7;-6;8
"TTGACT";-3;6;13;-3;-5;8
"TTGAGC";-5;0;23;-4;-6;8
"TTGCAA";-4;1;14;0;-3;8
"TTGGCT";-7;2;9;3;1;8
"TTGGGC";-9;-4;19;2;0;8
"TTGTAC";-7;0;23;-2;-6;8
"TTGTTA";1;-3;10;-3;3;8
"TTTCTT";1;4;9;-6;0;8
"AAGTCA";0;5;0;2;2;9
"AATCCT";0;12;-1;-1;-1;9
"AATCGC";-2;6;9;-2;-2;9
"AATTGT";-1;12;-1;0;-1;9
"AGACGG";5;2;-1;7;-4;9
"AGGACA";1;5;2;0;1;9
"AGGGCA";-3;1;-2;6;7;9
"AGTAGT";0;12;1;-2;-2;9
"AGTCAC";-3;6;11;-2;-3;9
"AGTCTA";5;3;-2;-3;6;9
"AGTGGT";-4;8;-3;4;4;9
"AGTTAT";-2;12;1;0;-2;9
"AGTTTC";2;2;7;-5;3;9
"ATTCGG";6;1;2;3;-3;9
"CATCCA";-2;3;-1;10;-1;9
"CATTCC";-5;2;8;8;-4;9
"CATTGA";-3;3;-1;11;-1;9
"CGATCG";2;-2;-2;17;-6;9
"CGTACC";-4;2;10;6;-5;9
"CGTAGA";-2;3;1;9;-2;9
"CGTGCC";-8;-2;6;12;1;9
"CGTGGA";-6;-1;-3;15;4;9
"CGTTAA";-4;3;1;11;-2;9
"CTACGT";-5;5;7;8;-6;9
"CTTTCG";3;-3;1;13;-5;9
"GAATCA";-1;4;2;3;1;9
"GAGAGG";5;3;-1;7;-5;9
"GAGGGG";1;-1;-5;13;1;9
"GAGTAG";3;3;-1;9;-5;9
"GCGCAT";4;6;0;-4;3;9
"GCGCTC";8;-4;6;-9;8;9
"GCGTTT";9;2;-4;-7;9;9
"GGAACA";0;4;4;1;0;9
"GGAGCA";-4;0;0;7;6;9
"GGGAAG";4;3;1;7;-6;9
"GGGGAG";0;-1;-3;13;0;9
"GTTACA";1;3;7;-3;1;9
"GTTGCA";-3;-1;3;3;7;9
"TAGCAT";-5;10;8;2;-6;9
"TAGCTC";-1;0;14;-3;-1;9
"TAGTTT";0;6;4;-1;0;9
"TCGCGG";10;-5;1;2;1;9
"TGGATT";1;6;6;-3;-1;9
"TGGGTT";-3;2;2;3;5;9
"TTACCC";-5;-1;23;-3;-5;9
"TTACGA";-3;0;14;0;-2;9
"TTATCT";-4;5;13;-1;-4;9
"TTATGC";-6;-1;23;-2;-5;9
"TTGCTG";7;-5;7;2;-2;9
"AAGCCG";6;3;-3;7;-3;10
"AAGTGG";5;3;-3;8;-3;10
"ACGCGT";6;6;-2;-5;5;10
"AGATCA";0;4;2;2;2;10
"AGGAGG";6;3;-1;6;-4;10
"AGGGGG";2;-1;-5;12;2;10
"AGGTAG";4;3;-1;8;-4;10
"ATGCTT";3;6;4;-5;2;10
"ATTTCA";1;3;5;-2;3;10
"CATCGG";3;1;-4;16;-6;10
"CCGCCC";2;-4;7;3;2;10
"CCGCGA";4;-3;-2;6;5;10
"CCGTCT";3;2;-3;5;3;10
"CCGTGC";1;-4;7;4;2;10
"CGTCAG";2;1;-2;16;-7;10
"CGTTTG";7;-3;-6;13;-1;10
"CTGAGT";-4;6;7;7;-6;10
"CTGCAC";-7;0;17;7;-7;10
"CTGCTA";1;-3;4;6;2;10
"CTGGGT";-8;2;3;13;0;10
"CTGTTC";-2;-4;13;4;-1;10
"GAACCG";5;2;-1;8;-4;10
"GAATGG";4;2;-1;9;-4;10
"GATACT";0;12;1;-1;-2;10
"GATAGC";-2;6;11;-2;-3;10
"GATCAA";-1;7;2;2;0;10
"GATGCT";-4;8;-3;5;4;10
"GATGGC";-6;2;7;4;3;10
"GATTAC";-4;6;11;0;-3;10
"GATTTA";4;3;-2;-1;6;10
"GCACGT";5;5;0;-4;4;10
"GCTTCG";13;-3;-6;1;5;10
"GGAAGG";5;2;1;7;-5;10
"GGAGGG";1;-2;-3;13;1;10
"GGATAG";3;2;1;9;-5;10
"GGCCCA";5;9;-4;-6;6;10
"GGCTCC";2;8;5;-8;3;10
"GGCTGA";4;9;-4;-5;6;10
"GGTAAC";-3;6;13;-2;-4;10
"GGTATA";5;3;0;-3;5;10
"GGTGAC";-7;2;9;4;2;10
"GGTGTA";1;-1;-4;3;11;10
"GTACTT";2;5;6;-4;1;10
"GTTAGG";6;1;4;3;-4;10
"GTTGGG";2;-3;0;9;2;10
"GTTTAG";4;1;4;5;-4;10
"TATTCG";4;1;2;7;-4;10
"TCGTCA";5;-3;4;-3;7;10
"TCTCCT";5;4;3;-6;4;10
"TCTCGC";3;-2;13;-7;3;10
"TCTTGT";4;4;3;-5;4;10
"TGACAT";-5;9;10;2;-6;10
"TGACTC";-1;-1;16;-3;-1;10
"TGATTT";0;5;6;-1;0;10
"TGTACG";5;1;4;5;-5;10
"TGTGCG";1;-3;0;11;1;10
"TTGACC";-4;0;23;-4;-5;10
"TTGAGA";-2;1;14;-1;-2;10
"TTGGCC";-8;-4;19;2;1;10
"TTGGGA";-6;-3;10;5;4;10
"TTGTAA";-4;1;14;1;-2;10
"TTTCAT";-4;8;13;-2;-5;10
"TTTCTC";0;-2;19;-7;0;10
"TTTTTT";1;4;9;-5;1;10
"AATCCC";-1;6;9;-2;-1;11
"AATCGA";1;7;0;1;2;11
"AATTCT";0;12;-1;0;0;11
"AATTGC";-2;6;9;-1;-1;11
"AGACCG";6;2;-1;7;-3;11
"AGATGG";5;2;-1;8;-3;11
"AGTACT";1;12;1;-2;-1;11
"AGTAGC";-1;6;11;-3;-2;11
"AGTCAA";0;7;2;1;1;11
"AGTGCT";-3;8;-3;4;5;11
"AGTGGC";-5;2;7;3;4;11
"AGTTAC";-3;6;11;-1;-2;11
"AGTTTA";5;3;-2;-2;7;11
"ATTCCG";7;1;2;3;-2;11
"ATTTGG";6;1;2;4;-2;11
"CAGCTT";0;6;-2;8;-1;11
"CATTCA";-2;3;-1;11;0;11
"CGTACA";-1;3;1;9;-1;11
"CGTGCA";-5;-1;-3;15;5;11
"CTACCT";-4;5;7;8;-5;11
"CTACGC";-6;-1;17;7;-6;11
"CTATGT";-5;5;7;9;-5;11
"CTGTAT";-6;6;7;9;-5;11
"GAGACG";6;3;-1;7;-4;11
"GAGGCG";2;-1;-5;13;2;11
"GATCTG";10;1;-5;4;1;11
"GCGAGT";6;6;0;-5;4;11
"GCGCAC";3;0;10;-5;3;11
"GCGCTA";11;-3;-3;-6;12;11
"GCGGGT";2;2;-4;1;10;11
"GCGTAT";4;6;0;-3;4;11
"GCGTTC";8;-4;6;-8;9;11
"GGCCGG";10;7;-7;0;1;11
"GTGATT";3;6;6;-5;1;11
"GTGGTT";-1;2;2;1;7;11
"TAACGT";-4;9;8;2;-4;11
"TAGAGT";-3;10;8;1;-5;11
"TAGCAC";-6;4;18;1;-6;11
"TAGCTA";2;1;5;0;3;11
"TAGGGT";-7;6;4;7;1;11
"TAGTAT";-5;10;8;3;-5;11
"TAGTTC";-1;0;14;-2;0;11
"TCGCCG";11;-5;1;2;2;11
"TCGTGG";10;-5;1;3;2;11
"TGGAAT";-4;10;10;1;-6;11
"TGGATC";0;0;16;-4;-1;11
"TGGGAT";-8;6;6;7;0;11
"TGGGTC";-4;-4;12;2;5;11
"TTACCA";-2;0;14;0;-1;11
"TTATCC";-5;-1;23;-2;-4;11
"TTATGA";-3;0;14;1;-1;11
"TTGCAG";2;-1;11;6;-7;11
"TTGTTG";7;-5;7;3;-1;11
"AAGTCG";6;3;-3;8;-2;12
"ACGCCT";7;6;-2;-5;6;12
"ACGCGC";5;0;8;-6;5;12
"ACGTGT";6;6;-2;-4;6;12
"AGGACG";7;3;-1;6;-3;12
"AGGGCG";3;-1;-5;12;3;12
"AGTCTG";11;1;-5;3;2;12
"ATGCAT";-2;10;8;-1;-3;12
"ATGCTC";2;0;14;-6;2;12
"ATGTTT";3;6;4;-4;3;12
"CATCCG";4;1;-4;16;-5;12
"CATTGG";3;1;-4;17;-5;12
"CCGCCA";5;-3;-2;6;6;12
"CCGTCC";2;-4;7;4;3;12
"CCGTGA";4;-3;-2;7;6;12
"CCTCGT";4;4;-3;4;3;12
"CGACTT";0;5;0;8;-1;12
"CGTAGG";4;1;-2;15;-6;12
"CGTGGG";0;-3;-6;21;0;12
"CGTTAG";2;1;-2;17;-6;12
"CTGACT";-3;6;7;7;-5;12
"CTGAGC";-5;0;17;6;-6;12
"CTGCAA";-4;1;8;10;-3;12
"CTGGCT";-7;2;3;13;1;12
"CTGGGC";-9;-4;13;12;0;12
"CTGTTA";1;-3;4;7;3;12
"CTTCTT";1;4;3;4;0;12
"GAATCG";5;2;-1;9;-3;12
"GATACC";-1;6;11;-2;-2;12
"GATAGA";1;7;2;1;1;12
"GATGCC";-5;2;7;4;4;12
"GATGGA";-3;3;-2;7;7;12
"GATTAA";-1;7;2;3;1;12
"GCACCT";6;5;0;-4;5;12
"GCACGC";4;-1;10;-5;4;12
"GCATGT";5;5;0;-3;5;12
"GGAACG";6;2;1;7;-4;12
"GGAGCG";2;-2;-3;13;2;12
"GGCTCA";5;9;-4;-5;7;12
"GGTAAA";0;7;4;1;0;12
"GGTGAA";-4;3;0;7;6;12
"GTACAT";-3;9;10;0;-4;12
"GTACTC";1;-1;16;-5;1;12
"GTATTT";2;5;6;-3;2;12
"GTTACG";7;1;4;3;-3;12
"GTTGCG";3;-3;0;9;3;12
"TAACCT";-3;9;8;2;-4;12
"TAACGC";-5;3;18;1;-5;12
"TAATGT";-4;9;8;3;-4;12
"TCTCCC";4;-2;13;-7;4;12
"TCTCGA";6;-1;4;-4;7;12
"TCTTCT";5;4;3;-5;5;12
"TCTTGC";3;-2;13;-6;4;12
"TGAAGT";-3;9;10;1;-5;12
"TGACAC";-6;3;20;1;-6;12
"TGACTA";2;0;7;0;3;12
"TGAGGT";-7;5;6;7;1;12
"TGATAT";-5;9;10;3;-5;12
"TGATTC";-1;-1;16;-2;0;12
"TTACGG";3;-2;11;6;-6;12
"TTGACA";-1;1;14;-1;-1;12
"TTGGCA";-5;-3;10;5;5;12
"TTTAGT";-2;8;13;-3;-4;12
"TTTCAC";-5;2;23;-3;-5;12
"TTTCTA";3;-1;10;-4;4;12
"TTTGGT";-6;4;9;3;2;12
"TTTTAT";-4;8;13;-1;-4;12
"TTTTTC";0;-2;19;-6;1;12
"AATCCA";2;7;0;1;3;13
"AATTCC";-1;6;9;-1;0;13
"AATTGA";1;7;0;2;3;13
"AGATCG";6;2;-1;8;-2;13
"AGTACC";0;6;11;-3;-1;13
"AGTAGA";2;7;2;0;2;13
"AGTGCC";-4;2;7;3;5;13
"AGTGGA";-2;3;-2;6;8;13
"AGTTAA";0;7;2;2;2;13
"ATACGT";-1;9;8;-1;-2;13
"ATTTCG";7;1;2;4;-1;13
"CAGCAT";-5;10;2;12;-6;13
"CAGCTC";-1;0;8;7;-1;13
"CAGTTT";0;6;-2;9;0;13
"CCGCGG";10;-5;-5;12;1;13
"CGGATT";1;6;0;7;-1;13
"CGGGTT";-3;2;-4;13;5;13
"CTACCC";-5;-1;17;7;-5;13
"CTACGA";-3;0;8;10;-2;13
"CTATCT";-4;5;7;9;-4;13
"CTGCTG";7;-5;1;12;-2;13
"CTGTAC";-7;0;17;8;-5;13
"GATCAG";5;5;-1;8;-4;13
"GATTTG";10;1;-5;5;2;13
"GCGACT";7;6;0;-5;5;13
"GCGAGC";5;0;10;-6;4;13
"GCGCAA";6;1;1;-2;7;13
"GCGGCT";3;2;-4;1;11;13
"GCGGGC";1;-4;6;0;10;13
"GCGTAC";3;0;10;-4;4;13
"GCGTTA";11;-3;-3;-5;13;13
"GCTCTT";11;4;-4;-8;10;13
"GGCCCG";11;7;-7;0;2;13
"GGCTGG";10;7;-7;1;2;13
"GGTATG";11;1;-3;3;1;13
"GGTGTG";7;-3;-7;9;7;13
"GTGAAT";-2;10;10;-1;-4;13
"GTGATC";2;0;16;-6;1;13
"GTGGAT";-6;6;6;5;2;13
"GTGGTC";-2;-4;12;0;7;13
"TAGACT";-2;10;8;1;-4;13
"TAGAGC";-4;4;18;0;-5;13
"TAGCAA";-3;5;9;4;-2;13
"TAGGCT";-6;6;4;7;2;13
"TAGGGC";-8;0;14;6;1;13
"TAGTAC";-6;4;18;2;-5;13
"TAGTTA";2;1;5;1;4;13
"TATCTT";2;8;4;-2;1;13
"TCGTCG";11;-5;1;3;3;13
"TGCCGT";2;14;2;-6;1;13
"TGGAAC";-5;4;20;0;-6;13
"TGGATA";3;1;7;-1;3;13
"TGGGAC";-9;0;16;6;0;13
"TGGGTA";-1;-3;3;5;9;13
"TTATCA";-2;0;14;1;0;13
"TTGAGG";4;-1;11;5;-6;13
"TTGGGG";0;-5;7;11;0;13
"TTGTAG";2;-1;11;7;-6;13
"AATCGG";7;5;-3;7;-2;14
"ACGCCC";6;0;8;-6;6;14
"ACGCGA";8;1;-1;-3;9;14
"ACGTCT";7;6;-2;-4;7;14
"ACGTGC";5;0;8;-5;6;14
"AGTCAG";6;5;-1;7;-3;14
"AGTTTG";11;1;-5;4;3;14
"ATGAGT";0;10;8;-2;-2;14
"ATGCAC";-3;4;18;-2;-3;14
"ATGCTA";5;1;5;-3;6;14
"ATGGGT";-4;6;4;4;4;14
"ATGTAT";-2;10;8;0;-2;14
"ATGTTC";2;0;14;-5;3;14
"CATTCG";4;1;-4;17;-4;14
"CCGTCA";5;-3;-2;7;7;14
"CCTCCT";5;4;-3;4;4;14
"CCTCGC";3;-2;7;3;3;14
"CCTTGT";4;4;-3;5;4;14
"CGACAT";-5;9;4;12;-6;14
"CGACTC";-1;-1;10;7;-1;14
"CGATTT";0;5;0;9;0;14
"CGTACG";5;1;-2;15;-5;14
"CGTGCG";1;-3;-6;21;1;14
"CTATGC";-5;-1;17;8;-5;14
"CTGACC";-4;0;17;6;-5;14
"CTGAGA";-2;1;8;9;-2;14
"CTGGCC";-8;-4;13;12;1;14
"CTGGGA";-6;-3;4;15;4;14
"CTGTAA";-4;1;8;11;-2;14
"CTTCAT";-4;8;7;8;-5;14
"CTTCTC";0;-2;13;3;0;14
"CTTTTT";1;4;3;5;1;14
"GATACA";2;7;2;1;2;14
"GATGCA";-2;3;-2;7;8;14
"GCACCC";5;-1;10;-5;5;14
"GCACGA";7;0;1;-2;8;14
"GCATCT";6;5;0;-3;6;14
"GCATGC";4;-1;10;-4;5;14
"GCGCTG";17;-5;-6;0;8;14
"GTAAGT";-1;9;10;-1;-3;14
"GTACAC";-4;3;20;-1;-4;14
"GTACTA";4;0;7;-2;5;14
"GTAGGT";-5;5;6;5;3;14
"GTATAT";-3;9;10;1;-3;14
"GTATTC";1;-1;16;-4;2;14
"TAACCC";-4;3;18;1;-4;14
"TAACGA";-2;4;9;4;-1;14
"TAATCT";-3;9;8;3;-3;14
"TAATGC";-5;3;18;2;-4;14
"TAGCTG";8;-1;2;6;-1;14
"TCTCCA";7;-1;4;-4;8;14
"TCTTCC";4;-2;13;-6;5;14
"TCTTGA";6;-1;4;-3;8;14
"TGAACT";-2;9;10;1;-4;14
"TGAAGC";-4;3;20;0;-5;14
"TGACAA";-3;4;11;4;-2;14
"TGAGCT";-6;5;6;7;2;14
"TGAGGC";-8;-1;16;6;1;14
"TGATAC";-6;3;20;2;-5;14
"TGATTA";2;0;7;1;4;14
"TTACCG";4;-2;11;6;-5;14
"TTATGG";3;-2;11;7;-5;14
"TTTACT";-1;8;13;-3;-3;14
"TTTAGC";-3;2;23;-4;-4;14
"TTTCAA";-2;3;14;0;-1;14
"TTTGCT";-5;4;9;3;3;14
"TTTGGC";-7;-2;19;2;2;14
"TTTTAC";-5;2;23;-2;-4;14
"TTTTTA";3;-1;10;-3;5;14
"AAGCTT";4;10;-1;-1;3;15
"AATTCA";2;7;0;2;4;15
"AGTACA";3;7;2;0;3;15
"AGTGCA";-1;3;-2;6;9;15
"ATACCT";0;9;8;-1;-1;15
"ATACGC";-2;3;18;-2;-2;15
"ATATGT";-1;9;8;0;-1;15
"CAACGT";-4;9;2;12;-4;15
"CAGAGT";-3;10;2;11;-5;15
"CAGCAC";-6;4;12;11;-6;15
"CAGCTA";2;1;-1;10;3;15
"CAGGGT";-7;6;-2;17;1;15
"CAGTTC";-1;0;8;8;0;15
"CCGCCG";11;-5;-5;12;2;15
"CCGTGG";10;-5;-5;13;2;15
"CGGAAT";-4;10;4;11;-6;15
"CGGATC";0;0;10;6;-1;15
"CGGGAT";-8;6;0;17;0;15
"CGGGTC";-4;-4;6;12;5;15
"CTACCA";-2;0;8;10;-1;15
"CTATCC";-5;-1;17;8;-4;15
"CTATGA";-3;0;8;11;-1;15
"CTGCAG";2;-1;5;16;-7;15
"CTGTTG";7;-5;1;13;-1;15
"GAACTT";3;9;1;0;2;15
"GATAGG";7;5;-1;7;-3;15
"GATGGG";3;1;-5;13;3;15
"GATTAG";5;5;-1;9;-3;15
"GCGACC";6;0;10;-6;5;15
"GCGAGA";8;1;1;-3;8;15
"GCGGCC";2;-4;6;0;11;15
"GCGGGA";4;-3;-3;3;14;15
"GCGTAA";6;1;1;-1;8;15
"GCTCAT";6;8;0;-4;5;15
"GCTCTC";10;-2;6;-9;10;15
"GCTTTT";11;4;-4;-7;11;15
"GGCTCG";11;7;-7;1;3;15
"GGTAAG";6;5;1;7;-4;15
"GGTGAG";2;1;-3;13;2;15
"GTCCGT";4;14;2;-8;3;15
"GTGAAC";-3;4;20;-2;-4;15
"GTGATA";5;1;7;-3;5;15
"GTGGAC";-7;0;16;4;2;15
"GTGGTA";1;-3;3;3;11;15
"TAGACC";-3;4;18;0;-4;15
"TAGAGA";-1;5;9;3;-1;15
"TAGGCC";-7;0;14;6;2;15
"TAGGGA";-5;1;5;9;5;15
"TAGTAA";-3;5;9;5;-1;15
"TATCAT";-3;12;8;2;-4;15
"TATCTC";1;2;14;-3;1;15
"TATTTT";2;8;4;-1;2;15
"TCTCGG";12;-3;1;2;3;15
"TGACTG";8;-2;4;6;-1;15
"TGCCCT";3;14;2;-6;2;15
"TGCCGC";1;8;12;-7;1;15
"TGCTGT";2;14;2;-5;2;15
"TGGAAA";-2;5;11;3;-2;15
"TGGGAA";-6;1;7;9;4;15
"TGTATT";3;8;6;-3;1;15
"TGTGTT";-1;4;2;3;7;15
"TTGACG";5;-1;11;5;-5;15
"TTGGCG";1;-5;7;11;1;15
"TTTCTG";9;-3;7;2;0;15
"AATCCG";8;5;-3;7;-1;16
"AATTGG";7;5;-3;8;-1;16
"ACGCCA";9;1;-1;-3;10;16
"ACGTCC";6;0;8;-5;7;16
"ACGTGA";8;1;-1;-2;10;16
"ACTCGT";8;8;-2;-5;7;16
"AGACTT";4;9;1;-1;3;16
"AGTAGG";8;5;-1;6;-2;16
"AGTGGG";4;1;-5;12;4;16
"AGTTAG";6;5;-1;8;-2;16
"ATGACT";1;10;8;-2;-1;16
"ATGAGC";-1;4;18;-3;-2;16
"ATGCAA";0;5;9;1;1;16
"ATGGCT";-3;6;4;4;5;16
"ATGGGC";-5;0;14;3;4;16
"ATGTAC";-3;4;18;-1;-2;16
"ATGTTA";5;1;5;-2;7;16
"ATTCTT";5;8;4;-5;4;16
"CAACCT";-3;9;2;12;-4;16
"CAACGC";-5;3;12;11;-5;16
"CAATGT";-4;9;2;13;-4;16
"CAGTAT";-5;10;2;13;-4;16
"CCTCCC";4;-2;7;3;4;16
"CCTCGA";6;-1;-2;6;7;16
"CCTTCT";5;4;-3;5;5;16
"CCTTGC";3;-2;7;4;4;16
"CGAAGT";-3;9;4;11;-5;16
"CGACAC";-6;3;14;11;-6;16
"CGACTA";2;0;1;10;3;16
"CGAGGT";-7;5;0;17;1;16
"CGATAT";-5;9;4;13;-5;16
"CGATTC";-1;-1;10;8;0;16
"CTACGG";3;-2;5;16;-6;16
"CTGACA";-1;1;8;9;-1;16
"CTGGCA";-5;-3;4;15;5;16
"CTTAGT";-2;8;7;7;-4;16
"CTTCAC";-5;2;17;7;-5;16
"CTTCTA";3;-1;4;6;4;16
"CTTGGT";-6;4;3;13;2;16
"CTTTAT";-4;8;7;9;-4;16
"CTTTTC";0;-2;13;4;1;16
"GAGATT";4;10;1;-1;2;16
"GAGGTT";0;6;-3;5;8;16
"GCACCA";8;0;1;-2;9;16
"GCATCC";5;-1;10;-4;6;16
"GCATGA";7;0;1;-1;9;16
"GCGCAG";12;-1;-2;4;3;16
"GCGTTG";17;-5;-6;1;9;16
"GTAACT";0;9;10;-1;-2;16
"GTAAGC";-2;3;20;-2;-3;16
"GTACAA";-1;4;11;2;0;16
"GTAGCT";-4;5;6;5;4;16
"GTAGGC";-6;-1;16;4;3;16
"GTATAC";-4;3;20;0;-3;16
"GTATTA";4;0;7;-1;6;16
"TAACCA";-1;4;9;4;0;16
"TAATCC";-4;3;18;2;-3;16
"TAATGA";-2;4;9;5;0;16
"TAGCAG";3;3;6;10;-6;16
"TAGTTG";8;-1;2;7;0;16
"TCGCTT";9;2;3;-6;8;16
"TCTTCA";7;-1;4;-3;9;16
"TGAACC";-3;3;20;0;-4;16
"TGAAGA";-1;4;11;3;-1;16
"TGAGCC";-7;-1;16;6;2;16
"TGAGGA";-5;0;7;9;5;16
"TGATAA";-3;4;11;5;-1;16
"TGGATG";9;-1;4;5;-1;16
"TGGGTG";5;-5;0;11;5;16
"TTATCG";4;-2;11;7;-4;16
"TTTACC";-2;2;23;-4;-3;16
"TTTAGA";0;3;14;-1;0;16
"TTTGCC";-6;-2;19;2;3;16
"TTTGGA";-4;-1;10;5;6;16
"TTTTAA";-2;3;14;1;0;16
"AAGCAT";-1;14;3;3;-2;17
"AAGCTC";3;4;9;-2;3;17
"AAGTTT";4;10;-1;0;4;17
"ACGCGG";14;-1;-4;3;5;17
"AGGATT";5;10;1;-2;3;17
"AGGGTT";1;6;-3;4;9;17
"ATACCC";-1;3;18;-2;-1;17
"ATACGA";1;4;9;1;2;17
"ATATCT";0;9;8;0;0;17
"ATATGC";-2;3;18;-1;-1;17
"ATGCTG";11;-1;2;3;2;17
"CAGACT";-2;10;2;11;-4;17
"CAGAGC";-4;4;12;10;-5;17
"CAGCAA";-3;5;3;14;-2;17
"CAGGCT";-6;6;-2;17;2;17
"CAGGGC";-8;0;8;16;1;17
"CAGTTA";2;1;-1;11;4;17
"CATCTT";2;8;-2;8;1;17
"CCGTCG";11;-5;-5;13;3;17
"CGCCGT";2;14;-4;4;1;17
"CGGAAC";-5;4;14;10;-6;17
"CGGATA";3;1;1;9;3;17
"CGGGAC";-9;0;10;16;0;17
"CGGGTA";-1;-3;-3;15;9;17
"CTATCA";-2;0;8;11;0;17
"CTGAGG";4;-1;5;15;-6;17
"CTGGGG";0;-5;1;21;0;17
"GAACAT";-2;13;5;4;-3;17
"GAACTC";2;3;11;-1;2;17
"GAATTT";3;9;1;1;3;17
"GATACG";8;5;-1;7;-2;17
"GATGCG";4;1;-5;13;4;17
"GCACGG";13;-2;-2;4;4;17
"GCGACA";9;1;1;-3;9;17
"GCGGCA";5;-3;-3;3;15;17
"GCTAGT";8;8;0;-5;6;17
"GCTCAC";5;2;10;-5;5;17
"GCTCTA";13;-1;-3;-6;14;17
"GCTGGT";4;4;-4;1;12;17
"GCTTAT";6;8;0;-3;6;17
"GCTTTC";10;-2;6;-8;11;17
"GGAATT";4;9;3;-1;2;17
"GGAGTT";0;5;-1;5;8;17
"GTACTG";10;-2;4;4;1;17
"GTCCCT";5;14;2;-8;4;17
"GTCCGC";3;8;12;-9;3;17
"GTCTGT";4;14;2;-7;4;17
"GTGAAA";0;5;11;1;0;17
"GTGGAA";-4;1;7;7;6;17
"GTTATT";5;8;6;-5;3;17
"GTTGTT";1;4;2;1;9;17
"TAACGG";4;2;6;10;-5;17
"TAGACA";0;5;9;3;0;17
"TAGGCA";-4;1;5;9;6;17
"TATAGT";-1;12;8;1;-3;17
"TATCAC";-4;6;18;1;-4;17
"TATCTA";4;3;5;0;5;17
"TATGGT";-5;8;4;7;3;17
"TATTAT";-3;12;8;3;-3;17
"TATTTC";1;2;14;-2;2;17
"TCTCCG";13;-3;1;2;4;17
"TCTTGG";12;-3;1;3;4;17
"TGACAG";3;2;8;10;-6;17
"TGATTG";8;-2;4;7;0;17
"TGCCCC";2;8;12;-7;2;17
"TGCCGA";4;9;3;-4;5;17
"TGCTCT";3;14;2;-5;3;17
"TGCTGC";1;8;12;-6;2;17
"TGTAAT";-2;12;10;1;-4;17
"TGTATC";2;2;16;-4;1;17
"TGTGAT";-6;8;6;7;2;17
"TGTGTC";-2;-2;12;2;7;17
"TTTCAG";4;1;11;6;-5;17
"TTTTTG";9;-3;7;3;1;17
"AAACGT";0;13;3;3;-1;18
"AATTCG";8;5;-3;8;0;18
"ACGTCA";9;1;-1;-2;11;18
"ACTCCT";9;8;-2;-5;8;18
"ACTCGC";7;2;8;-6;7;18
"ACTTGT";8;8;-2;-4;8;18
"AGACAT";-1;13;5;3;-2;18
"AGACTC";3;3;11;-2;3;18
"AGATTT";4;9;1;0;4;18
"AGTACG";9;5;-1;6;-1;18
"AGTGCG";5;1;-5;12;5;18
"ATGACC";0;4;18;-3;-1;18
"ATGAGA";2;5;9;0;2;18
"ATGGCC";-4;0;14;3;5;18
"ATGGGA";-2;1;5;6;8;18
"ATGTAA";0;5;9;2;2;18
"ATTCAT";0;12;8;-1;-1;18
"ATTCTC";4;2;14;-6;4;18
"ATTTTT";5;8;4;-4;5;18
"CAACCC";-4;3;12;11;-4;18
"CAACGA";-2;4;3;14;-1;18
"CAATCT";-3;9;2;13;-3;18
"CAGCTG";8;-1;-4;16;-1;18
"CAGTAC";-6;4;12;12;-4;18
"CCTCCA";7;-1;-2;6;8;18
"CCTTCC";4;-2;7;4;5;18
"CCTTGA";6;-1;-2;7;8;18
"CGAACT";-2;9;4;11;-4;18
"CGAAGC";-4;3;14;10;-5;18
"CGACAA";-3;4;5;14;-2;18
"CGAGCT";-6;5;0;17;2;18
"CGAGGC";-8;-1;10;16;1;18
"CGATAC";-6;3;14;12;-5;18
"CGATTA";2;0;1;11;4;18
"CTACCG";4;-2;5;16;-5;18
"CTATGG";3;-2;5;17;-5;18
"CTGTAG";2;-1;5;17;-5;18
"CTTACT";-1;8;7;7;-3;18
"CTTAGC";-3;2;17;6;-4;18
"CTTCAA";-2;3;8;10;-1;18
"CTTGCT";-5;4;3;13;3;18
"CTTGGC";-7;-2;13;12;2;18
"CTTTAC";-5;2;17;8;-4;18
"CTTTTA";3;-1;4;7;5;18
"GAGAAT";-1;14;5;3;-3;18
"GAGATC";3;4;11;-2;2;18
"GAGGAT";-5;10;1;9;3;18
"GAGGTC";-1;0;7;4;8;18
"GCATCA";8;0;1;-1;10;18
"GCGAGG";14;-1;-2;3;4;18
"GCGGGG";10;-5;-6;9;10;18
"GCGTAG";12;-1;-2;5;4;18
"GGCCTT";9;14;-5;-8;8;18
"GTAACC";-1;3;20;-2;-2;18
"GTAAGA";1;4;11;1;1;18
"GTAGCC";-5;-1;16;4;4;18
"GTAGGA";-3;0;7;7;7;18
"GTATAA";-1;4;11;3;1;18
"GTGATG";11;-1;4;3;1;18
"GTGGTG";7;-5;0;9;7;18
"TAATCA";-1;4;9;5;1;18
"TAGAGG";5;3;6;9;-5;18
"TAGGGG";1;-1;2;15;1;18
"TAGTAG";3;3;6;11;-5;18
"TCGCAT";4;6;7;-2;3;18
"TCGCTC";8;-4;13;-7;8;18
"TCGTTT";9;2;3;-5;9;18
"TGAACA";0;4;11;3;0;18
"TGAGCA";-4;0;7;9;6;18
"TGGAAG";4;3;8;9;-6;18
"TGGGAG";0;-1;4;15;0;18
"TTTACA";1;3;14;-1;1;18
"TTTGCA";-3;-1;10;5;7;18
"AAGAGT";1;14;3;2;-1;19
"AAGCAC";-2;8;13;2;-2;19
"AAGCTA";6;5;0;1;7;19
"AAGGGT";-3;10;-1;8;5;19
"AAGTAT";-1;14;3;4;-1;19
"AAGTTC";3;4;9;-1;4;19
"ACGCCG";15;-1;-4;3;6;19
"ACGTGG";14;-1;-4;4;6;19
"AGGAAT";0;14;5;2;-2;19
"AGGATC";4;4;11;-3;3;19
"AGGGAT";-4;10;1;8;4;19
"AGGGTC";0;0;7;3;9;19
"ATACCA";2;4;9;1;3;19
"ATATCC";-1;3;18;-1;0;19
"ATATGA";1;4;9;2;3;19
"ATGCAG";6;3;6;7;-3;19
"ATGTTG";11;-1;2;4;3;19
"CAATGC";-4;3;12;12;-4;19
"CAGACC";-3;4;12;10;-4;19
"CAGAGA";-1;5;3;13;-1;19
"CAGGCC";-7;0;8;16;2;19
"CAGGGA";-5;1;-1;19;5;19
"CAGTAA";-3;5;3;15;-1;19
"CATCAT";-3;12;2;12;-4;19
"CATCTC";1;2;8;7;1;19
"CATTTT";2;8;-2;9;2;19
"CCTCGG";12;-3;-5;12;3;19
"CGACTG";8;-2;-2;16;-1;19
"CGCCCT";3;14;-4;4;2;19
"CGCCGC";1;8;6;3;1;19
"CGCTGT";2;14;-4;5;2;19
"CGGAAA";-2;5;5;13;-2;19
"CGGGAA";-6;1;1;19;4;19
"CGTATT";3;8;0;7;1;19
"CGTGTT";-1;4;-4;13;7;19
"CTGACG";5;-1;5;15;-5;19
"CTGGCG";1;-5;1;21;1;19
"CTTCTG";9;-3;1;12;0;19
"GAAAGT";0;13;5;3;-2;19
"GAACAC";-3;7;15;3;-3;19
"GAACTA";5;4;2;2;6;19
"GAAGGT";-4;9;1;9;4;19
"GAATAT";-2;13;5;5;-2;19
"GAATTC";2;3;11;0;3;19
"GCACCG";14;-2;-2;4;5;19
"GCATGG";13;-2;-2;5;5;19
"GCTACT";9;8;0;-5;7;19
"GCTAGC";7;2;10;-6;6;19
"GCTCAA";8;3;1;-2;9;19
"GCTGCT";5;4;-4;1;13;19
"GCTGGC";3;-2;6;0;12;19
"GCTTAC";5;2;10;-4;6;19
"GCTTTA";13;-1;-3;-5;15;19
"GGAAAT";-1;13;7;3;-3;19
"GGAATC";3;3;13;-2;2;19
"GGAGAT";-5;9;3;9;3;19
"GGAGTC";-1;-1;9;4;8;19
"GTACAG";5;2;8;8;-4;19
"GTATTG";10;-2;4;5;2;19
"GTCCCC";4;8;12;-9;4;19
"GTCCGA";6;9;3;-6;7;19
"GTCTCT";5;14;2;-7;5;19
"GTCTGC";3;8;12;-8;4;19
"GTTAAT";0;12;10;-1;-2;19
"GTTATC";4;2;16;-6;3;19
"GTTGAT";-4;8;6;5;4;19
"GTTGTC";0;-2;12;0;9;19
"TAACCG";5;2;6;10;-4;19
"TAATGG";4;2;6;11;-4;19
"TATACT";0;12;8;1;-2;19
"TATAGC";-2;6;18;0;-3;19
"TATCAA";-1;7;9;4;0;19
"TATGCT";-4;8;4;7;4;19
"TATGGC";-6;2;14;6;3;19
"TATTAC";-4;6;18;2;-3;19
"TATTTA";4;3;5;1;6;19
"TCACGT";5;5;7;-2;4;19
"TCTTCG";13;-3;1;3;5;19
"TGAAGG";5;2;8;9;-5;19
"TGAGGG";1;-2;4;15;1;19
"TGATAG";3;2;8;11;-5;19
"TGCCCA";5;9;3;-4;6;19
"TGCTCC";2;8;12;-6;3;19
"TGCTGA";4;9;3;-3;6;19
"TGTAAC";-3;6;20;0;-4;19
"TGTATA";5;3;7;-1;5;19
"TGTGAC";-7;2;16;6;2;19
"TGTGTA";1;-1;3;5;11;19
"TTACTT";2;5;13;-2;1;19
"TTTAGG";6;1;11;5;-4;19
"TTTGGG";2;-3;7;11;2;19
"TTTTAG";4;1;11;7;-4;19
"AAACCT";1;13;3;3;0;20
"AAACGC";-1;7;13;2;-1;20
"AAATGT";0;13;3;4;0;20
"ACTCCC";8;2;8;-6;8;20
"ACTCGA";10;3;-1;-3;11;20
"ACTTCT";9;8;-2;-4;9;20
"ACTTGC";7;2;8;-5;8;20
"AGAAGT";1;13;5;2;-1;20
"AGACAC";-2;7;15;2;-2;20
"AGACTA";6;4;2;1;7;20
"AGAGGT";-3;9;1;8;5;20
"AGATAT";-1;13;5;4;-1;20
"AGATTC";3;3;11;-1;4;20
"ATACGG";7;2;6;7;-2;20
"ATGACA";3;5;9;0;3;20
"ATGGCA";-1;1;5;6;9;20
"ATTAGT";2;12;8;-2;0;20
"ATTCAC";-1;6;18;-2;-1;20
"ATTCTA";7;3;5;-3;8;20
"ATTGGT";-2;8;4;4;6;20
"ATTTAT";0;12;8;0;0;20
"ATTTTC";4;2;14;-5;5;20
"CAACCA";-1;4;3;14;0;20
"CAATCC";-4;3;12;12;-3;20
"CAATGA";-2;4;3;15;0;20
"CAGCAG";3;3;0;20;-6;20
"CAGTTG";8;-1;-4;17;0;20
"CCGCTT";9;2;-3;4;8;20
"CCTTCA";7;-1;-2;7;9;20
"CGAACC";-3;3;14;10;-4;20
"CGAAGA";-1;4;5;13;-1;20
"CGAGCC";-7;-1;10;16;2;20
"CGAGGA";-5;0;1;19;5;20
"CGATAA";-3;4;5;15;-1;20
"CGGATG";9;-1;-2;15;-1;20
"CGGGTG";5;-5;-6;21;5;20
"CTATCG";4;-2;5;17;-4;20
"CTTACC";-2;2;17;6;-3;20
"CTTAGA";0;3;8;9;0;20
"CTTGCC";-6;-2;13;12;3;20
"CTTGGA";-4;-1;4;15;6;20
"CTTTAA";-2;3;8;11;0;20
"GAGAAC";-2;8;15;2;-3;20
"GAGATA";6;5;2;1;6;20
"GAGGAC";-6;4;11;8;3;20
"GAGGTA";2;1;-2;7;12;20
"GCGACG";15;-1;-2;3;5;20
"GCGGCG";11;-5;-6;9;11;20
"GCTCTG";19;-3;-6;0;10;20
"GGCCAT";4;18;-1;-4;3;20
"GGCCTC";8;8;5;-9;8;20
"GGCTTT";9;14;-5;-7;9;20
"GTAACA";2;4;11;1;2;20
"GTAGCA";-2;0;7;7;8;20
"GTGAAG";6;3;8;7;-4;20
"GTGGAG";2;-1;4;13;2;20
"TAGACG";6;3;6;9;-4;20
"TAGGCG";2;-1;2;15;2;20
"TATCTG";10;1;2;6;1;20
"TCGAGT";6;6;7;-3;4;20
"TCGCAC";3;0;17;-3;3;20
"TCGCTA";11;-3;4;-4;12;20
"TCGGGT";2;2;3;3;10;20
"TCGTAT";4;6;7;-1;4;20
"TCGTTC";8;-4;13;-6;9;20
"TGCCGG";10;7;0;2;1;20
"TTGATT";3;6;13;-3;1;20
"TTGGTT";-1;2;9;3;7;20
"AAGACT";2;14;3;2;0;21
"AAGAGC";0;8;13;1;-1;21
"AAGCAA";1;9;4;5;2;21
"AAGGCT";-2;10;-1;8;6;21
"AAGGGC";-4;4;9;7;5;21
"AAGTAC";-2;8;13;3;-1;21
"AAGTTA";6;5;0;2;8;21
"AATCTT";6;12;-1;-1;5;21
"ACGTCG";15;-1;-4;4;7;21
"AGCCGT";6;18;-3;-5;5;21
"AGGAAC";-1;8;15;1;-2;21
"AGGATA";7;5;2;0;7;21
"AGGGAC";-5;4;11;7;4;21
"AGGGTA";3;1;-2;6;13;21
"ATATCA";2;4;9;2;4;21
"ATGAGG";8;3;6;6;-2;21
"ATGGGG";4;-1;2;12;4;21
"ATGTAG";6;3;6;8;-2;21
"CAACGG";4;2;0;20;-5;21
"CAGACA";0;5;3;13;0;21
"CAGGCA";-4;1;-1;19;6;21
"CATAGT";-1;12;2;11;-3;21
"CATCAC";-4;6;12;11;-4;21
"CATCTA";4;3;-1;10;5;21
"CATGGT";-5;8;-2;17;3;21
"CATTAT";-3;12;2;13;-3;21
"CATTTC";1;2;8;8;2;21
"CCTCCG";13;-3;-5;12;4;21
"CCTTGG";12;-3;-5;13;4;21
"CGACAG";3;2;2;20;-6;21
"CGATTG";8;-2;-2;17;0;21
"CGCCCC";2;8;6;3;2;21
"CGCCGA";4;9;-3;6;5;21
"CGCTCT";3;14;-4;5;3;21
"CGCTGC";1;8;6;4;2;21
"CGTAAT";-2;12;4;11;-4;21
"CGTATC";2;2;10;6;1;21
"CGTGAT";-6;8;0;17;2;21
"CGTGTC";-2;-2;6;12;7;21
"CTTCAG";4;1;5;16;-5;21
"CTTTTG";9;-3;1;13;1;21
"GAAACT";1;13;5;3;-1;21
"GAAAGC";-1;7;15;2;-2;21
"GAACAA";0;8;6;6;1;21
"GAAGCT";-3;9;1;9;5;21
"GAAGGC";-5;3;11;8;4;21
"GAATAC";-3;7;15;4;-2;21
"GAATTA";5;4;2;3;7;21
"GACCGT";5;18;-3;-4;5;21
"GCATCG";14;-2;-2;5;6;21
"GCTACC";8;2;10;-6;7;21
"GCTAGA";10;3;1;-3;10;21
"GCTGCC";4;-2;6;0;13;21
"GCTGGA";6;-1;-3;3;16;21
"GCTTAA";8;3;1;-1;10;21
"GGAAAC";-2;7;17;2;-3;21
"GGAATA";6;4;4;1;6;21
"GGAGAC";-6;3;13;8;3;21
"GGAGTA";2;0;0;7;12;21
"GTAAGG";7;2;8;7;-3;21
"GTAGGG";3;-2;4;13;3;21
"GTATAG";5;2;8;9;-3;21
"GTCCCA";7;9;3;-6;8;21
"GTCTCC";4;8;12;-8;5;21
"GTCTGA";6;9;3;-5;8;21
"GTTAAC";-1;6;20;-2;-2;21
"GTTATA";7;3;7;-3;7;21
"GTTGAC";-5;2;16;4;4;21
"GTTGTA";3;-1;3;3;13;21
"TAATCG";5;2;6;11;-3;21
"TATACC";-1;6;18;0;-2;21
"TATAGA";1;7;9;3;1;21
"TATGCC";-5;2;14;6;4;21
"TATGGA";-3;3;5;9;7;21
"TATTAA";-1;7;9;5;1;21
"TCACCT";6;5;7;-2;5;21
"TCACGC";4;-1;17;-3;4;21
"TCATGT";5;5;7;-1;5;21
"TGAACG";6;2;8;9;-4;21
"TGAGCG";2;-2;4;15;2;21
"TGCTCA";5;9;3;-3;7;21
"TGTAAA";0;7;11;3;0;21
"TGTGAA";-4;3;7;9;6;21
"TTACAT";-3;9;17;2;-4;21
"TTACTC";1;-1;23;-3;1;21
"TTATTT";2;5;13;-1;2;21
"TTTACG";7;1;11;5;-3;21
"TTTGCG";3;-3;7;11;3;21
"AAACCC";0;7;13;2;0;22
"AAACGA";2;8;4;5;3;22
"AAATCT";1;13;3;4;1;22
"AAATGC";-1;7;13;3;0;22
"AAGCTG";12;3;-3;7;3;22
"ACTCCA";11;3;-1;-3;12;22
"ACTTCC";8;2;8;-5;9;22
"ACTTGA";10;3;-1;-2;12;22
"AGAACT";2;13;5;2;0;22
"AGAAGC";0;7;15;1;-1;22
"AGACAA";1;8;6;5;2;22
"AGAGCT";-2;9;1;8;6;22
"AGAGGC";-4;3;11;7;5;22
"AGATAC";-2;7;15;3;-1;22
"AGATTA";6;4;2;2;8;22
"ATACCG";8;2;6;7;-1;22
"ATATGG";7;2;6;8;-1;22
"ATTACT";3;12;8;-2;1;22
"ATTAGC";1;6;18;-3;0;22
"ATTCAA";2;7;9;1;3;22
"ATTGCT";-1;8;4;4;7;22
"ATTGGC";-3;2;14;3;6;22
"ATTTAC";-1;6;18;-1;0;22
"ATTTTA";7;3;5;-2;9;22
"CAATCA";-1;4;3;15;1;22
"CAGAGG";5;3;0;19;-5;22
"CAGGGG";1;-1;-4;25;1;22
"CCGCAT";4;6;1;8;3;22
"CCGCTC";8;-4;7;3;8;22
"CCGTTT";9;2;-3;5;9;22
"CGAACA";0;4;5;13;0;22
"CGAGCA";-4;0;1;19;6;22
"CGGAAG";4;3;2;19;-6;22
"CGGGAG";0;-1;-2;25;0;22
"CTTACA";1;3;8;9;1;22
"CTTGCA";-3;-1;4;15;7;22
"GAACTG";11;2;-1;8;2;22
"GACCCT";6;18;-3;-4;5;22
"GACCGC";4;12;7;-5;4;22
"GACTGT";5;18;-3;-3;5;22
"GAGAAA";1;9;6;5;1;22
"GAGGAA";-3;5;2;11;7;22
"GATATT";6;12;1;-1;4;22
"GATGTT";2;8;-3;5;10;22
"GCTCAG";14;1;-2;4;5;22
"GCTTTG";19;-3;-6;1;11;22
"GGCAGT";6;18;-1;-5;4;22
"GGCCAC";3;12;9;-5;3;22
"GGCCTA";11;9;-4;-6;12;22
"GGCGGT";2;14;-5;1;10;22
"GGCTAT";4;18;-1;-3;4;22
"GGCTTC";8;8;5;-8;9;22
"GTCCGG";12;7;0;0;3;22
"TATCAG";5;5;6;10;-4;22
"TATTTG";10;1;2;7;2;22
"TCGACT";7;6;7;-3;5;22
"TCGAGC";5;0;17;-4;4;22
"TCGCAA";6;1;8;0;7;22
"TCGGCT";3;2;3;3;11;22
"TCGGGC";1;-4;13;2;10;22
"TCGTAC";3;0;17;-2;4;22
"TCGTTA";11;-3;4;-3;13;22
"TCTCTT";11;4;3;-6;10;22
"TGCCCG";11;7;0;2;2;22
"TGCTGG";10;7;0;3;2;22
"TGTATG";11;1;4;5;1;22
"TGTGTG";7;-3;0;11;7;22
"TTGAAT";-2;10;17;1;-4;22
"TTGATC";2;0;23;-4;1;22
"TTGGAT";-6;6;13;7;2;22
"TTGGTC";-2;-4;19;2;7;22
"AAGACC";1;8;13;1;0;23
"AAGAGA";3;9;4;4;3;23
"AAGGCC";-3;4;9;7;6;23
"AAGGGA";-1;5;0;10;9;23
"AAGTAA";1;9;4;6;3;23
"AATCAT";1;16;3;3;0;23
"AATCTC";5;6;9;-2;5;23
"AATTTT";6;12;-1;0;6;23
"ACTCGG";16;1;-4;3;7;23
"AGACTG";12;2;-1;7;3;23
"AGCCCT";7;18;-3;-5;6;23
"AGCCGC";5;12;7;-6;5;23
"AGCTGT";6;18;-3;-4;6;23
"AGGAAA";2;9;6;4;2;23
"AGGGAA";-2;5;2;10;8;23
"AGTATT";7;12;1;-2;5;23
"AGTGTT";3;8;-3;4;11;23
"ATGACG";9;3;6;6;-1;23
"ATGGCG";5;-1;2;12;5;23
"ATTCTG";13;1;2;3;4;23
"CAACCG";5;2;0;20;-4;23
"CAATGG";4;2;0;21;-4;23
"CAGTAG";3;3;0;21;-4;23
"CATACT";0;12;2;11;-2;23
"CATAGC";-2;6;12;10;-3;23
"CATCAA";-1;7;3;14;0;23
"CATGCT";-4;8;-2;17;4;23
"CATGGC";-6;2;8;16;3;23
"CATTAC";-4;6;12;12;-3;23
"CATTTA";4;3;-1;11;6;23
"CCACGT";5;5;1;8;4;23
"CCTTCG";13;-3;-5;13;5;23
"CGAAGG";5;2;2;19;-5;23
"CGAGGG";1;-2;-2;25;1;23
"CGATAG";3;2;2;21;-5;23
"CGCCCA";5;9;-3;6;6;23
"CGCTCC";2;8;6;4;3;23
"CGCTGA";4;9;-3;7;6;23
"CGTAAC";-3;6;14;10;-4;23
"CGTATA";5;3;1;9;5;23
"CGTGAC";-7;2;10;16;2;23
"CGTGTA";1;-1;-3;15;11;23
"CTACTT";2;5;7;8;1;23
"CTTAGG";6;1;5;15;-4;23
"CTTGGG";2;-3;1;21;2;23
"CTTTAG";4;1;5;17;-4;23
"GAAACC";0;7;15;2;-1;23
"GAAAGA";2;8;6;5;2;23
"GAAGCC";-4;3;11;8;5;23
"GAAGGA";-2;4;2;11;8;23
"GAATAA";0;8;6;7;2;23
"GAGATG";12;3;-1;7;2;23
"GAGGTG";8;-1;-5;13;8;23
"GCTACA";11;3;1;-3;11;23
"GCTGCA";7;-1;-3;3;17;23
"GGAAAA";1;8;8;5;1;23
"GGAGAA";-3;4;4;11;7;23
"GTAACG";8;2;8;7;-2;23
"GTAGCG";4;-2;4;13;4;23
"GTCTCA";7;9;3;-5;9;23
"GTTAAA";2;7;11;1;2;23
"GTTGAA";-2;3;7;7;8;23
"TATACA";2;7;9;3;2;23
"TATGCA";-2;3;5;9;8;23
"TCACCC";5;-1;17;-3;5;23
"TCACGA";7;0;8;0;8;23
"TCATCT";6;5;7;-1;6;23
"TCATGC";4;-1;17;-2;5;23
"TCGCTG";17;-5;1;2;8;23
"TTAAGT";-1;9;17;1;-3;23
"TTACAC";-4;3;27;1;-4;23
"TTACTA";4;0;14;0;5;23
"TTAGGT";-5;5;13;7;3;23
"TTATAT";-3;9;17;3;-3;23
"TTATTC";1;-1;23;-2;2;23
"AAACCA";3;8;4;5;4;24
"AAATCC";0;7;13;3;1;24
"AAATGA";2;8;4;6;4;24
"AAGCAG";7;7;1;11;-2;24
"AAGTTG";12;3;-3;8;4;24
"ACGCTT";13;6;-2;-5;12;24
"ACTTCA";11;3;-1;-2;13;24
"AGAACC";1;7;15;1;0;24
"AGAAGA";3;8;6;4;3;24
"AGAGCC";-3;3;11;7;6;24
"AGAGGA";-1;4;2;10;9;24
"AGATAA";1;8;6;6;3;24
"AGGATG";13;3;-1;6;3;24
"AGGGTG";9;-1;-5;12;9;24
"ATATCG";8;2;6;8;0;24
"ATTACC";2;6;18;-3;1;24
"ATTAGA";4;7;9;0;4;24
"ATTGCC";-2;2;14;3;7;24
"ATTGGA";0;3;5;6;10;24
"ATTTAA";2;7;9;2;4;24
"CAGACG";6;3;0;19;-4;24
"CAGGCG";2;-1;-4;25;2;24
"CATCTG";10;1;-4;16;1;24
"CCGAGT";6;6;1;7;4;24
"CCGCAC";3;0;11;7;3;24
"CCGCTA";11;-3;-2;6;12;24
"CCGGGT";2;2;-3;13;10;24
"CCGTTC";8;-4;7;4;9;24
"CGCCGG";10;7;-6;12;1;24
"CTGATT";3;6;7;7;1;24
"CTGGTT";-1;2;3;13;7;24
"GAACAG";6;6;3;12;-3;24
"GAATTG";11;2;-1;9;3;24
"GACCCC";5;12;7;-5;5;24
"GACCGA";7;13;-2;-2;8;24
"GACTCT";6;18;-3;-3;6;24
"GACTGC";4;12;7;-4;5;24
"GATAAT";1;16;5;3;-1;24
"GATATC";5;6;11;-2;4;24
"GATGAT";-3;12;1;9;5;24
"GATGTC";1;2;7;4;10;24
"GCACTT";12;5;0;-4;11;24
"GCTAGG";16;1;-2;3;6;24
"GCTGGG";12;-3;-6;9;12;24
"GCTTAG";14;1;-2;5;6;24
"GGAATG";12;2;1;7;2;24
"GGAGTG";8;-2;-3;13;8;24
"GGCACT";7;18;-1;-5;5;24
"GGCAGC";5;12;9;-6;4;24
"GGCCAA";6;13;0;-2;7;24
"GGCGCT";3;14;-5;1;11;24
"GGCGGC";1;8;5;0;10;24
"GGCTAC";3;12;9;-4;4;24
"GGCTTA";11;9;-4;-5;13;24
"GTCCCG";13;7;0;0;4;24
"GTCTGG";12;7;0;1;4;24
"GTTATG";13;1;4;3;3;24
"GTTGTG";9;-3;0;9;9;24
"TAACTT";3;9;8;2;2;24
"TATAGG";7;5;6;9;-3;24
"TATGGG";3;1;2;15;3;24
"TATTAG";5;5;6;11;-3;24
"TCGACC";6;0;17;-4;5;24
"TCGAGA";8;1;8;-1;8;24
"TCGGCC";2;-4;13;2;11;24
"TCGGGA";4;-3;4;5;14;24
"TCGTAA";6;1;8;1;8;24
"TCTCAT";6;8;7;-2;5;24
"TCTCTC";10;-2;13;-7;10;24
"TCTTTT";11;4;3;-5;11;24
"TGCTCG";11;7;0;3;3;24
"TGTAAG";6;5;8;9;-4;24
"TGTGAG";2;1;4;15;2;24
"TTCCGT";4;14;9;-6;3;24
"TTGAAC";-3;4;27;0;-4;24
"TTGATA";5;1;14;-1;5;24
"TTGGAC";-7;0;23;6;2;24
"TTGGTA";1;-3;10;5;11;24
"AAACGG";8;6;1;11;-1;25
"AAGACA";4;9;4;4;4;25
"AAGGCA";0;5;0;10;10;25
"AATAGT";3;16;3;2;1;25
"AATCAC";0;10;13;2;0;25
"AATCTA";8;7;0;1;9;25
"AATGGT";-1;12;-1;8;7;25
"AATTAT";1;16;3;4;1;25
"AATTTC";5;6;9;-1;6;25
"ACTCCG";17;1;-4;3;8;25
"ACTTGG";16;1;-4;4;8;25
"AGACAG";7;6;3;11;-2;25
"AGATTG";12;2;-1;8;4;25
"AGCCCC";6;12;7;-6;6;25
"AGCCGA";8;13;-2;-3;9;25
"AGCTCT";7;18;-3;-4;7;25
"AGCTGC";5;12;7;-5;6;25
"AGTAAT";2;16;5;2;0;25
"AGTATC";6;6;11;-3;5;25
"AGTGAT";-2;12;1;8;6;25
"AGTGTC";2;2;7;3;11;25
"ATTCAG";8;5;6;7;-1;25
"ATTTTG";13;1;2;4;5;25
"CAATCG";5;2;0;21;-3;25
"CATACC";-1;6;12;10;-2;25
"CATAGA";1;7;3;13;1;25
"CATGCC";-5;2;8;16;4;25
"CATGGA";-3;3;-1;19;7;25
"CATTAA";-1;7;3;15;1;25
"CCACCT";6;5;1;8;5;25
"CCACGC";4;-1;11;7;4;25
"CCATGT";5;5;1;9;5;25
"CCGTAT";4;6;1;9;5;25
"CGAACG";6;2;2;19;-4;25
"CGAGCG";2;-2;-2;25;2;25
"CGCTCA";5;9;-3;7;7;25
"CGTAAA";0;7;5;13;0;25
"CGTGAA";-4;3;1;19;6;25
"CTACAT";-3;9;11;12;-4;25
"CTACTC";1;-1;17;7;1;25
"CTATTT";2;5;7;9;2;25
"CTTACG";7;1;5;15;-3;25
"CTTGCG";3;-3;1;21;3;25
"GAAACA";3;8;6;5;3;25
"GAAGCA";-1;4;2;11;9;25
"GAGAAG";7;7;3;11;-3;25
"GAGGAG";3;3;-1;17;3;25
"GCGATT";13;6;0;-5;11;25
"GCGGTT";9;2;-4;1;17;25
"GGCCTG";17;7;-7;0;8;25
"TAGATT";4;10;8;1;2;25
"TAGGTT";0;6;4;7;8;25
"TCACCA";8;0;8;0;9;25
"TCATCC";5;-1;17;-2;6;25
"TCATGA";7;0;8;1;9;25
"TCGCAG";12;-1;5;6;3;25
"TCGTTG";17;-5;1;3;9;25
"TTAACT";0;9;17;1;-2;25
"TTAAGC";-2;3;27;0;-3;25
"TTACAA";-1;4;18;4;0;25
"TTAGCT";-4;5;13;7;4;25
"TTAGGC";-6;-1;23;6;3;25
"TTATAC";-4;3;27;2;-3;25
"TTATTA";4;0;14;1;6;25
"AAATCA";3;8;4;6;5;26
"AAGAGG";9;7;1;10;-1;26
"AAGGGG";5;3;-3;16;5;26
"AAGTAG";7;7;1;12;-1;26
"ACGCAT";8;10;2;-1;7;26
"ACGCTC";12;0;8;-6;12;26
"ACGTTT";13;6;-2;-4;13;26
"AGAACA";4;8;6;4;4;26
"AGAGCA";0;4;2;10;10;26
"AGGAAG";8;7;3;10;-2;26
"AGGGAG";4;3;-1;16;4;26
"ATTACA";5;7;9;0;5;26
"ATTGCA";1;3;5;6;11;26
"CATCAG";5;5;0;20;-4;26
"CATTTG";10;1;-4;17;2;26
"CCGACT";7;6;1;7;5;26
"CCGAGC";5;0;11;6;4;26
"CCGCAA";6;1;2;10;7;26
"CCGGCT";3;2;-3;13;11;26
"CCGGGC";1;-4;7;12;10;26
"CCGTTA";11;-3;-2;7;13;26
"CCTCTT";11;4;-3;4;10;26
"CGCCCG";11;7;-6;12;2;26
"CGCTGG";10;7;-6;13;2;26
"CGTATG";11;1;-2;15;1;26
"CGTGTG";7;-3;-6;21;7;26
"CTGAAT";-2;10;11;11;-4;26
"CTGATC";2;0;17;6;1;26
"CTGGAT";-6;6;7;17;2;26
"CTGGTC";-2;-4;13;12;7;26
"GAAAGG";8;6;3;11;-2;26
"GAAGGG";4;2;-1;17;4;26
"GAATAG";6;6;3;13;-2;26
"GACCCA";8;13;-2;-2;9;26
"GACTCC";5;12;7;-4;6;26
"GACTGA";7;13;-2;-1;9;26
"GATAAC";0;10;15;2;-1;26
"GATATA";8;7;2;1;8;26
"GATGAC";-4;6;11;8;5;26
"GATGTA";4;3;-2;7;14;26
"GCACAT";7;9;4;0;6;26
"GCACTC";11;-1;10;-5;11;26
"GCATTT";12;5;0;-3;12;26
"GCTACG";17;1;-2;3;7;26
"GCTGCG";13;-3;-6;9;13;26
"GGAAAG";7;6;5;11;-3;26
"GGAGAG";3;2;1;17;3;26
"GGCACC";6;12;9;-6;5;26
"GGCAGA";8;13;0;-3;8;26
"GGCGCC";2;8;5;0;11;26
"GGCGGA";4;9;-4;3;14;26
"GGCTAA";6;13;0;-1;8;26
"GTCTCG";13;7;0;1;5;26
"GTTAAG";8;5;8;7;-2;26
"GTTGAG";4;1;4;13;4;26
"TAACAT";-2;13;12;6;-3;26
"TAACTC";2;3;18;1;2;26
"TAATTT";3;9;8;3;3;26
"TATACG";8;5;6;9;-2;26
"TATGCG";4;1;2;15;4;26
"TCACGG";13;-2;5;6;4;26
"TCGACA";9;1;8;-1;9;26
"TCGGCA";5;-3;4;5;15;26
"TCTAGT";8;8;7;-3;6;26
"TCTCAC";5;2;17;-3;5;26
"TCTCTA";13;-1;4;-4;14;26
"TCTGGT";4;4;3;3;12;26
"TCTTAT";6;8;7;-1;6;26
"TCTTTC";10;-2;13;-6;11;26
"TGAATT";4;9;10;1;2;26
"TGAGTT";0;5;6;7;8;26
"TTACTG";10;-2;11;6;1;26
"TTCCCT";5;14;9;-6;4;26
"TTCCGC";3;8;19;-7;3;26
"TTCTGT";4;14;9;-5;4;26
"TTGAAA";0;5;18;3;0;26
"TTGGAA";-4;1;14;9;6;26
"TTTATT";5;8;13;-3;3;26
"TTTGTT";1;4;9;3;9;26
"AAACCG";9;6;1;11;0;27
"AAATGG";8;6;1;12;0;27
"AATACT";4;16;3;2;2;27
"AATAGC";2;10;13;1;1;27
"AATCAA";3;11;4;5;4;27
"AATGCT";0;12;-1;8;8;27
"AATGGC";-2;6;9;7;7;27
"AATTAC";0;10;13;3;1;27
"AATTTA";8;7;0;2;10;27
"ACACGT";9;9;2;-1;8;27
"ACTTCG";17;1;-4;4;9;27
"AGAAGG";9;6;3;10;-1;27
"AGAGGG";5;2;-1;16;5;27
"AGATAG";7;6;3;12;-1;27
"AGCCCA";9;13;-2;-3;10;27
"AGCTCC";6;12;7;-5;7;27
"AGCTGA";8;13;-2;-2;10;27
"AGTAAC";1;10;15;1;0;27
"AGTATA";9;7;2;0;9;27
"AGTGAC";-3;6;11;7;6;27
"AGTGTA";5;3;-2;6;15;27
"ATACTT";6;9;8;-1;5;27
"ATTAGG";10;5;6;6;0;27
"ATTGGG";6;1;2;12;6;27
"ATTTAG";8;5;6;8;0;27
"CATACA";2;7;3;13;2;27
"CATGCA";-2;3;-1;19;8;27
"CCACCC";5;-1;11;7;5;27
"CCACGA";7;0;2;10;8;27
"CCATCT";6;5;1;9;6;27
"CCGCTG";17;-5;-5;12;8;27
"CCGTAC";3;0;11;8;5;27
"CTAAGT";-1;9;11;11;-3;27
"CTACAC";-4;3;21;11;-4;27
"CTACTA";4;0;8;10;5;27
"CTAGGT";-5;5;7;17;3;27
"CTATAT";-3;9;11;13;-3;27
"CTATTC";1;-1;17;8;2;27
"GACCGG";13;11;-5;4;4;27
"GCGAAT";8;10;4;-1;6;27
"GCGATC";12;0;10;-6;11;27
"GCGGAT";4;6;0;5;12;27
"GCGGTC";8;-4;6;0;17;27
"GGCCAG";12;11;-3;4;3;27
"GGCTTG";17;7;-7;1;9;27
"TAGAAT";-1;14;12;5;-3;27
"TAGATC";3;4;18;0;2;27
"TAGGAT";-5;10;8;11;3;27
"TAGGTC";-1;0;14;6;8;27
"TCATCA";8;0;8;1;10;27
"TCGAGG";14;-1;5;5;4;27
"TCGGGG";10;-5;1;11;10;27
"TCGTAG";12;-1;5;7;4;27
"TGCCTT";9;14;2;-6;8;27
"TTAACC";-1;3;27;0;-2;27
"TTAAGA";1;4;18;3;1;27
"TTAGCC";-5;-1;23;6;4;27
"TTAGGA";-3;0;14;9;7;27
"TTATAA";-1;4;18;5;1;27
"TTGATG";11;-1;11;5;1;27
"TTGGTG";7;-5;7;11;7;27
"AAGACG";10;7;1;10;0;28
"AAGGCG";6;3;-3;16;6;28
"AATCTG";14;5;-3;7;5;28
"ACGAGT";10;10;2;-2;8;28
"ACGCAC";7;4;12;-2;7;28
"ACGCTA";15;1;-1;-3;16;28
"ACGGGT";6;6;-2;4;14;28
"ACGTAT";8;10;2;0;8;28
"ACGTTC";12;0;8;-5;13;28
"AGCCGG";14;11;-5;3;5;28
"ATGATT";7;10;8;-2;5;28
"ATGGTT";3;6;4;4;11;28
"CAACTT";3;9;2;12;2;28
"CATAGG";7;5;0;19;-3;28
"CATGGG";3;1;-4;25;3;28
"CATTAG";5;5;0;21;-3;28
"CCATGC";5;-1;11;8;5;28
"CCGACC";6;0;11;6;5;28
"CCGAGA";8;1;2;9;8;28
"CCGGCC";2;-4;7;12;11;28
"CCGGGA";4;-3;-2;15;14;28
"CCGTAA";6;1;2;11;8;28
"CCTCAT";6;8;1;8;5;28
"CCTCTC";10;-2;7;3;10;28
"CCTTTT";11;4;-3;5;11;28
"CGCTCG";11;7;-6;13;3;28
"CGTAAG";6;5;2;19;-4;28
"CGTGAG";2;1;-2;25;2;28
"CTCCGT";4;14;3;4;3;28
"CTGAAC";-3;4;21;10;-4;28
"CTGATA";5;1;8;9;5;28
"CTGGAC";-7;0;17;16;2;28
"CTGGTA";1;-3;4;15;11;28
"GAAACG";9;6;3;11;-1;28
"GAAGCG";5;2;-1;17;5;28
"GACTCA";8;13;-2;-1;10;28
"GATAAA";3;11;6;5;3;28
"GATGAA";-1;7;2;11;9;28
"GCAAGT";9;9;4;-1;7;28
"GCACAC";6;3;14;-1;6;28
"GCACTA";14;0;1;-2;15;28
"GCAGGT";5;5;0;5;13;28
"GCATAT";7;9;4;1;7;28
"GCATTC";11;-1;10;-4;12;28
"GGCACA";9;13;0;-3;9;28
"GGCGCA";5;9;-4;3;15;28
"GTAATT";6;9;10;-1;4;28
"GTAGTT";2;5;6;5;10;28
"TAAAGT";0;13;12;5;-2;28
"TAACAC";-3;7;22;5;-3;28
"TAACTA";5;4;9;4;6;28
"TAAGGT";-4;9;8;11;4;28
"TAATAT";-2;13;12;7;-2;28
"TAATTC";2;3;18;2;3;28
"TCACCG";14;-2;5;6;5;28
"TCATGG";13;-2;5;7;5;28
"TCTACT";9;8;7;-3;7;28
"TCTAGC";7;2;17;-4;6;28
"TCTCAA";8;3;8;0;9;28
"TCTGCT";5;4;3;3;13;28
"TCTGGC";3;-2;13;2;12;28
"TCTTAC";5;2;17;-2;6;28
"TCTTTA";13;-1;4;-3;15;28
"TGAAAT";-1;13;14;5;-3;28
"TGAATC";3;3;20;0;2;28
"TGAGAT";-5;9;10;11;3;28
"TGAGTC";-1;-1;16;6;8;28
"TTACAG";5;2;15;10;-4;28
"TTATTG";10;-2;11;7;2;28
"TTCCCC";4;8;19;-7;4;28
"TTCCGA";6;9;10;-4;7;28
"TTCTCT";5;14;9;-5;5;28
"TTCTGC";3;8;19;-6;4;28
"TTTAAT";0;12;17;1;-2;28
"TTTATC";4;2;23;-4;3;28
"TTTGAT";-4;8;13;7;4;28
"TTTGTC";0;-2;19;2;9;28
"AAATCG";9;6;1;12;1;29
"AATACC";3;10;13;1;2;29
"AATAGA";5;11;4;4;5;29
"AATGCC";-1;6;9;7;8;29
"AATGGA";1;7;0;10;11;29
"AATTAA";3;11;4;6;5;29
"ACACCT";10;9;2;-1;9;29
"ACACGC";8;3;12;-2;8;29
"ACATGT";9;9;2;0;9;29
"AGAACG";10;6;3;10;0;29
"AGAGCG";6;2;-1;16;6;29
"AGCTCA";9;13;-2;-2;11;29
"AGTAAA";4;11;6;4;4;29
"AGTGAA";0;7;2;10;10;29
"ATACAT";1;13;12;3;0;29
"ATACTC";5;3;18;-2;5;29
"ATATTT";6;9;8;0;6;29
"ATTACG";11;5;6;6;1;29
"ATTGCG";7;1;2;12;7;29
"CAGATT";4;10;2;11;2;29
"CAGGTT";0;6;-2;17;8;29
"CCACCA";8;0;2;10;9;29
"CCATCC";5;-1;11;8;6;29
"CCATGA";7;0;2;11;9;29
"CCGCAG";12;-1;-1;16;3;29
"CCGTTG";17;-5;-5;13;9;29
"CTAACT";0;9;11;11;-2;29
"CTAAGC";-2;3;21;10;-3;29
"CTACAA";-1;4;12;14;0;29
"CTAGCT";-4;5;7;17;4;29
"CTAGGC";-6;-1;17;16;3;29
"CTATAC";-4;3;21;12;-3;29
"CTATTA";4;0;8;11;6;29
"GACCCG";14;11;-5;4;5;29
"GACTGG";13;11;-5;5;5;29
"GATATG";14;5;-1;7;4;29
"GATGTG";10;1;-5;13;10;29
"GCCCGT";14;14;-4;-8;13;29
"GCGAAC";7;4;14;-2;6;29
"GCGATA";15;1;1;-3;15;29
"GCGGAC";3;0;10;4;12;29
"GCGGTA";11;-3;-3;3;21;29
"GGCAGG";14;11;-3;3;4;29
"GGCGGG";10;7;-7;9;10;29
"GGCTAG";12;11;-3;5;4;29
"GTCCTT";11;14;2;-8;10;29
"TAGAAC";-2;8;22;4;-3;29
"TAGATA";6;5;9;3;6;29
"TAGGAC";-6;4;18;10;3;29
"TAGGTA";2;1;5;9;12;29
"TCGACG";15;-1;5;5;5;29
"TCGGCG";11;-5;1;11;11;29
"TCTCTG";19;-3;1;2;10;29
"TGCCAT";4;18;6;-2;3;29
"TGCCTC";8;8;12;-7;8;29
"TGCTTT";9;14;2;-5;9;29
"TTAACA";2;4;18;3;2;29
"TTAGCA";-2;0;14;9;8;29
"TTGAAG";6;3;15;9;-4;29
"TTGGAG";2;-1;11;15;2;29
"AATCAG";9;9;1;11;0;30
"AATTTG";14;5;-3;8;6;30
"ACGACT";11;10;2;-2;9;30
"ACGAGC";9;4;12;-3;8;30
"ACGCAA";10;5;3;1;11;30
"ACGGCT";7;6;-2;4;15;30
"ACGGGC";5;0;8;3;14;30
"ACGTAC";7;4;12;-1;8;30
"ACGTTA";15;1;-1;-2;17;30
"ACTCTT";15;8;-2;-5;14;30
"AGCCCG";15;11;-5;3;6;30
"AGCTGG";14;11;-5;4;6;30
"AGTATG";15;5;-1;6;5;30
"AGTGTG";11;1;-5;12;11;30
"ATGAAT";2;14;12;2;0;30
"ATGATC";6;4;18;-3;5;30
"ATGGAT";-2;10;8;8;6;30
"ATGGTC";2;0;14;3;11;30
"CAACAT";-2;13;6;16;-3;30
"CAACTC";2;3;12;11;2;30
"CAATTT";3;9;2;13;3;30
"CATACG";8;5;0;19;-2;30
"CATGCG";4;1;-4;25;4;30
"CCACGG";13;-2;-1;16;4;30
"CCGACA";9;1;2;9;9;30
"CCGGCA";5;-3;-2;15;15;30
"CCTAGT";8;8;1;7;6;30
"CCTCAC";5;2;11;7;5;30
"CCTCTA";13;-1;-2;6;14;30
"CCTGGT";4;4;-3;13;12;30
"CCTTAT";6;8;1;9;6;30
"CCTTTC";10;-2;7;4;11;30
"CGAATT";4;9;4;11;2;30
"CGAGTT";0;5;0;17;8;30
"CTACTG";10;-2;5;16;1;30
"CTCCCT";5;14;3;4;4;30
"CTCCGC";3;8;13;3;3;30
"CTCTGT";4;14;3;5;4;30
"CTGAAA";0;5;12;13;0;30
"CTGGAA";-4;1;8;19;6;30
"CTTATT";5;8;7;7;3;30
"CTTGTT";1;4;3;13;9;30
"GCAACT";10;9;4;-1;8;30
"GCAAGC";8;3;14;-2;7;30
"GCACAA";9;4;5;2;10;30
"GCAGCT";6;5;0;5;14;30
"GCAGGC";4;-1;10;4;13;30
"GCATAC";6;3;14;0;7;30
"GCATTA";14;0;1;-1;16;30
"GTAAAT";1;13;14;3;-1;30
"GTAATC";5;3;20;-2;4;30
"GTAGAT";-3;9;10;9;5;30
"GTAGTC";1;-1;16;4;10;30
"TAAACT";1;13;12;5;-1;30
"TAAAGC";-1;7;22;4;-2;30
"TAACAA";0;8;13;8;1;30
"TAAGCT";-3;9;8;11;5;30
"TAAGGC";-5;3;18;10;4;30
"TAATAC";-3;7;22;6;-2;30
"TAATTA";5;4;9;5;7;30
"TACCGT";5;18;4;-2;5;30
"TCATCG";14;-2;5;7;6;30
"TCTACC";8;2;17;-4;7;30
"TCTAGA";10;3;8;-1;10;30
"TCTGCC";4;-2;13;2;13;30
"TCTGGA";6;-1;4;5;16;30
"TCTTAA";8;3;8;1;10;30
"TGAAAC";-2;7;24;4;-3;30
"TGAATA";6;4;11;3;6;30
"TGAGAC";-6;3;20;10;3;30
"TGAGTA";2;0;7;9;12;30
"TTAAGG";7;2;15;9;-3;30
"TTAGGG";3;-2;11;15;3;30
"TTATAG";5;2;15;11;-3;30
"TTCCCA";7;9;10;-4;8;30
"TTCTCC";4;8;19;-6;5;30
"TTCTGA";6;9;10;-3;8;30
"TTTAAC";-1;6;27;0;-2;30
"TTTATA";7;3;14;-1;7;30
"TTTGAC";-5;2;23;6;4;30
"TTTGTA";3;-1;10;5;13;30
"AATACA";6;11;4;4;6;31
"AATGCA";2;7;0;10;12;31
"ACACCC";9;3;12;-2;9;31
"ACACGA";11;4;3;1;12;31
"ACATCT";10;9;2;0;10;31
"ACATGC";8;3;12;-1;9;31
"ACGCTG";21;-1;-4;3;12;31
"ATAAGT";3;13;12;2;1;31
"ATACAC";0;7;22;2;0;31
"ATACTA";8;4;9;1;9;31
"ATAGGT";-1;9;8;8;7;31
"ATATAT";1;13;12;4;1;31
"ATATTC";5;3;18;-1;6;31
"CAGAAT";-1;14;6;15;-3;31
"CAGATC";3;4;12;10;2;31
"CAGGAT";-5;10;2;21;3;31
"CAGGTC";-1;0;8;16;8;31
"CCATCA";8;0;2;11;10;31
"CCGAGG";14;-1;-1;15;4;31
"CCGGGG";10;-5;-5;21;10;31
"CGCCTT";9;14;-4;4;8;31
"CTAACC";-1;3;21;10;-2;31
"CTAAGA";1;4;12;13;1;31
"CTAGCC";-5;-1;17;16;4;31
"CTAGGA";-3;0;8;19;7;31
"CTATAA";-1;4;12;15;1;31
"CTGATG";11;-1;5;15;1;31
"CTGGTG";7;-5;1;21;7;31
"GACTCG";14;11;-5;5;6;31
"GATAAG";9;9;3;11;-1;31
"GATGAG";5;5;-1;17;5;31
"GCACTG";20;-2;-2;4;11;31
"GCCCCT";15;14;-4;-8;14;31
"GCCCGC";13;8;6;-9;13;31
"GCCTGT";14;14;-4;-7;14;31
"GCGAAA";10;5;5;1;10;31
"GCGGAA";6;1;1;7;16;31
"GCTATT";15;8;0;-5;13;31
"GCTGTT";11;4;-4;1;19;31
"GGCACG";15;11;-3;3;5;31
"GGCGCG";11;7;-7;9;11;31
"GTCCAT";6;18;6;-4;5;31
"GTCCTC";10;8;12;-9;10;31
"GTCTTT";11;14;2;-7;11;31
"TAACTG";11;2;6;10;2;31
"TACCCT";6;18;4;-2;5;31
"TACCGC";4;12;14;-3;4;31
"TACTGT";5;18;4;-1;5;31
"TAGAAA";1;9;13;7;1;31
"TAGGAA";-3;5;9;13;7;31
"TATATT";6;12;8;1;4;31
"TATGTT";2;8;4;7;10;31
"TCTCAG";14;1;5;6;5;31
"TCTTTG";19;-3;1;3;11;31
"TGCAGT";6;18;6;-3;4;31
"TGCCAC";3;12;16;-3;3;31
"TGCCTA";11;9;3;-4;12;31
"TGCGGT";2;14;2;3;10;31
"TGCTAT";4;18;6;-1;4;31
"TGCTTC";8;8;12;-6;9;31
"TTCCGG";12;7;7;2;3;31
"AAACTT";7;13;3;3;6;32
"AATAGG";11;9;1;10;1;32
"AATGGG";7;5;-3;16;7;32
"AATTAG";9;9;1;12;1;32
"ACGACC";10;4;12;-3;9;32
"ACGAGA";12;5;3;0;12;32
"ACGGCC";6;0;8;3;15;32
"ACGGGA";8;1;-1;6;18;32
"ACGTAA";10;5;3;2;12;32
"ACTCAT";10;12;2;-1;9;32
"ACTCTC";14;2;8;-6;14;32
"ACTTTT";15;8;-2;-4;15;32
"AGCTCG";15;11;-5;4;7;32
"AGTAAG";10;9;3;10;0;32
"AGTGAG";6;5;-1;16;6;32
"ATCCGT";8;18;4;-5;7;32
"ATGAAC";1;8;22;1;0;32
"ATGATA";9;5;9;0;9;32
"ATGGAC";-3;4;18;7;6;32
"ATGGTA";5;1;5;6;15;32
"CAAAGT";0;13;6;15;-2;32
"CAACAC";-3;7;16;15;-3;32
"CAACTA";5;4;3;14;6;32
"CAAGGT";-4;9;2;21;4;32
"CAATAT";-2;13;6;17;-2;32
"CAATTC";2;3;12;12;3;32
"CCACCG";14;-2;-1;16;5;32
"CCATGG";13;-2;-1;17;5;32
"CCGTAG";12;-1;-1;17;5;32
"CCTACT";9;8;1;7;7;32
"CCTAGC";7;2;11;6;6;32
"CCTCAA";8;3;2;10;9;32
"CCTGCT";5;4;-3;13;13;32
"CCTGGC";3;-2;7;12;12;32
"CCTTAC";5;2;11;8;6;32
"CCTTTA";13;-1;-2;7;15;32
"CGAAAT";-1;13;8;15;-3;32
"CGAATC";3;3;14;10;2;32
"CGAGAT";-5;9;4;21;3;32
"CGAGTC";-1;-1;10;16;8;32
"CTACAG";5;2;9;20;-4;32
"CTATTG";10;-2;5;17;2;32
"CTCCCC";4;8;13;3;4;32
"CTCCGA";6;9;4;6;7;32
"CTCTCT";5;14;3;5;5;32
"CTCTGC";3;8;13;4;4;32
"CTTAAT";0;12;11;11;-2;32
"CTTATC";4;2;17;6;3;32
"CTTGAT";-4;8;7;17;4;32
"CTTGTC";0;-2;13;12;9;32
"GCAACC";9;3;14;-2;8;32
"GCAAGA";11;4;5;1;11;32
"GCAGCC";5;-1;10;4;14;32
"GCAGGA";7;0;1;7;17;32
"GCATAA";9;4;5;3;11;32
"GCGATG";21;-1;-2;3;11;32
"GCGGTG";17;-5;-6;9;17;32
"GTAAAC";0;7;24;2;-1;32
"GTAATA";8;4;11;1;8;32
"GTAGAC";-4;3;20;8;5;32
"GTAGTA";4;0;7;7;14;32
"TAAACC";0;7;22;4;-1;32
"TAAAGA";2;8;13;7;2;32
"TAAGCC";-4;3;18;10;5;32
"TAAGGA";-2;4;9;13;8;32
"TAATAA";0;8;13;9;2;32
"TAGATG";12;3;6;9;2;32
"TAGGTG";8;-1;2;15;8;32
"TCTACA";11;3;8;-1;11;32
"TCTGCA";7;-1;4;5;17;32
"TGAAAA";1;8;15;7;1;32
"TGAGAA";-3;4;11;13;7;32
"TTAACG";8;2;15;9;-2;32
"TTAGCG";4;-2;11;15;4;32
"TTCTCA";7;9;10;-3;9;32
"TTTAAA";2;7;18;3;2;32
"TTTGAA";-2;3;14;9;8;32
"AAGATT";8;14;3;2;6;33
"AAGGTT";4;10;-1;8;12;33
"ACACCA";12;4;3;1;13;33
"ACATCC";9;3;12;-1;10;33
"ACATGA";11;4;3;2;13;33
"ACGCAG";16;3;0;7;7;33
"ACGTTG";21;-1;-4;4;13;33
"ATAACT";4;13;12;2;2;33
"ATAAGC";2;7;22;1;1;33
"ATACAA";3;8;13;5;4;33
"ATAGCT";0;9;8;8;8;33
"ATAGGC";-2;3;18;7;7;33
"ATATAC";0;7;22;3;1;33
"ATATTA";8;4;9;2;10;33
"CAGAAC";-2;8;16;14;-3;33
"CAGATA";6;5;3;13;6;33
"CAGGAC";-6;4;12;20;3;33
"CAGGTA";2;1;-1;19;12;33
"CCGACG";15;-1;-1;15;5;33
"CCGGCG";11;-5;-5;21;11;33
"CCTCTG";19;-3;-5;12;10;33
"CGCCAT";4;18;0;8;3;33
"CGCCTC";8;8;6;3;8;33
"CGCTTT";9;14;-4;5;9;33
"CTAACA";2;4;12;13;2;33
"CTAGCA";-2;0;8;19;8;33
"CTGAAG";6;3;9;19;-4;33
"CTGGAG";2;-1;5;25;2;33
"GAAATT";7;13;5;3;5;33
"GAAGTT";3;9;1;9;11;33
"GCACAG";15;2;2;8;6;33
"GCATTG";20;-2;-2;5;12;33
"GCCCCC";14;8;6;-9;14;33
"GCCCGA";16;9;-3;-6;17;33
"GCCTCT";15;14;-4;-7;15;33
"GCCTGC";13;8;6;-8;14;33
"GCTAAT";10;12;4;-1;8;33
"GCTATC";14;2;10;-6;13;33
"GCTGAT";6;8;0;5;14;33
"GCTGTC";10;-2;6;0;19;33
"GTCAGT";8;18;6;-5;6;33
"GTCCAC";5;12;16;-5;5;33
"GTCCTA";13;9;3;-6;14;33
"GTCGGT";4;14;2;1;12;33
"GTCTAT";6;18;6;-3;6;33
"GTCTTC";10;8;12;-8;11;33
"TAACAG";6;6;10;14;-3;33
"TAATTG";11;2;6;11;3;33
"TACCCC";5;12;14;-3;5;33
"TACCGA";7;13;5;0;8;33
"TACTCT";6;18;4;-1;6;33
"TACTGC";4;12;14;-2;5;33
"TATAAT";1;16;12;5;-1;33
"TATATC";5;6;18;0;4;33
"TATGAT";-3;12;8;11;5;33
"TATGTC";1;2;14;6;10;33
"TCACTT";12;5;7;-2;11;33
"TCTAGG";16;1;5;5;6;33
"TCTGGG";12;-3;1;11;12;33
"TCTTAG";14;1;5;7;6;33
"TGAATG";12;2;8;9;2;33
"TGAGTG";8;-2;4;15;8;33
"TGCACT";7;18;6;-3;5;33
"TGCAGC";5;12;16;-4;4;33
"TGCCAA";6;13;7;0;7;33
"TGCGCT";3;14;2;3;11;33
"TGCGGC";1;8;12;2;10;33
"TGCTAC";3;12;16;-2;4;33
"TGCTTA";11;9;3;-3;13;33
"TTCCCG";13;7;7;2;4;33
"TTCTGG";12;7;7;3;4;33
"TTTATG";13;1;11;5;3;33
"TTTGTG";9;-3;7;11;9;33
"AAACAT";2;17;7;7;1;34
"AAACTC";6;7;13;2;6;34
"AAATTT";7;13;3;4;7;34
"AATACG";12;9;1;10;2;34
"AATGCG";8;5;-3;16;8;34
"ACACGG";17;2;0;7;8;34
"ACGACA";13;5;3;0;13;34
"ACGGCA";9;1;-1;6;19;34
"ACTAGT";12;12;2;-2;10;34
"ACTCAC";9;6;12;-2;9;34
"ACTCTA";17;3;-1;-3;18;34
"ACTGGT";8;8;-2;4;16;34
"ACTTAT";10;12;2;0;10;34
"ACTTTC";14;2;8;-5;15;34
"AGAATT";8;13;5;2;6;34
"AGAGTT";4;9;1;8;12;34
"ATACTG";14;2;6;7;5;34
"ATCCCT";9;18;4;-5;8;34
"ATCCGC";7;12;14;-6;7;34
"ATCTGT";8;18;4;-4;8;34
"ATGAAA";4;9;13;4;4;34
"ATGGAA";0;5;9;10;10;34
"ATTATT";9;12;8;-2;7;34
"ATTGTT";5;8;4;4;13;34
"CAAACT";1;13;6;15;-1;34
"CAAAGC";-1;7;16;14;-2;34
"CAACAA";0;8;7;18;1;34
"CAAGCT";-3;9;2;21;5;34
"CAAGGC";-5;3;12;20;4;34
"CAATAC";-3;7;16;16;-2;34
"CAATTA";5;4;3;15;7;34
"CACCGT";5;18;-2;8;5;34
"CCATCG";14;-2;-1;17;6;34
"CCTACC";8;2;11;6;7;34
"CCTAGA";10;3;2;9;10;34
"CCTGCC";4;-2;7;12;13;34
"CCTGGA";6;-1;-2;15;16;34
"CCTTAA";8;3;2;11;10;34
"CGAAAC";-2;7;18;14;-3;34
"CGAATA";6;4;5;13;6;34
"CGAGAC";-6;3;14;20;3;34
"CGAGTA";2;0;1;19;12;34
"CTAAGG";7;2;9;19;-3;34
"CTAGGG";3;-2;5;25;3;34
"CTATAG";5;2;9;21;-3;34
"CTCCCA";7;9;4;6;8;34
"CTCTCC";4;8;13;4;5;34
"CTCTGA";6;9;4;7;8;34
"CTTAAC";-1;6;21;10;-2;34
"CTTATA";7;3;8;9;7;34
"CTTGAC";-5;2;17;16;4;34
"CTTGTA";3;-1;4;15;13;34
"GACCTT";12;18;-3;-4;11;34
"GCAACA";12;4;5;1;12;34
"GCAGCA";8;0;1;7;18;34
"GCGAAG";16;3;2;7;6;34
"GCGGAG";12;-1;-2;13;12;34
"GTAAAA";3;8;15;5;3;34
"GTAGAA";-1;4;11;11;9;34
"TAAACA";3;8;13;7;3;34
"TAAGCA";-1;4;9;13;9;34
"TAGAAG";7;7;10;13;-3;34
"TAGGAG";3;3;6;19;3;34
"TCGATT";13;6;7;-3;11;34
"TCGGTT";9;2;3;3;17;34
"TGCCTG";17;7;0;2;8;34
"AAGAAT";3;18;7;6;1;35
"AAGATC";7;8;13;1;6;35
"AAGGAT";-1;14;3;12;7;35
"AAGGTC";3;4;9;7;12;35
"ACATCA";12;4;3;2;14;35
"ACGAGG";18;3;0;6;8;35
"ACGGGG";14;-1;-4;12;14;35
"ACGTAG";16;3;0;8;8;35
"AGCCTT";13;18;-3;-5;12;35
"ATAACC";3;7;22;1;2;35
"ATAAGA";5;8;13;4;5;35
"ATAGCC";-1;3;18;7;8;35
"ATAGGA";1;4;9;10;11;35
"ATATAA";3;8;13;6;5;35
"ATGATG";15;3;6;6;5;35
"ATGGTG";11;-1;2;12;11;35
"CAACTG";11;2;0;20;2;35
"CACCCT";6;18;-2;8;5;35
"CACCGC";4;12;8;7;4;35
"CACTGT";5;18;-2;9;5;35
"CAGAAA";1;9;7;17;1;35
"CAGGAA";-3;5;3;23;7;35
"CATATT";6;12;2;11;4;35
"CATGTT";2;8;-2;17;10;35
"CCTCAG";14;1;-1;16;5;35
"CCTTTG";19;-3;-5;13;11;35
"CGCAGT";6;18;0;7;4;35
"CGCCAC";3;12;10;7;3;35
"CGCCTA";11;9;-3;6;12;35
"CGCGGT";2;14;-4;13;10;35
"CGCTAT";4;18;0;9;4;35
"CGCTTC";8;8;6;4;9;35
"CTCCGG";12;7;1;12;3;35
"GAAAAT";2;17;9;7;0;35
"GAAATC";6;7;15;2;5;35
"GAAGAT";-2;13;5;13;6;35
"GAAGTC";2;3;11;8;11;35
"GCAAGG";17;2;2;7;7;35
"GCAGGG";13;-2;-2;13;13;35
"GCATAG";15;2;2;9;7;35
"GCCCCA";17;9;-3;-6;18;35
"GCCTCC";14;8;6;-8;15;35
"GCCTGA";16;9;-3;-5;18;35
"GCTAAC";9;6;14;-2;8;35
"GCTATA";17;3;1;-3;17;35
"GCTGAC";5;2;10;4;14;35
"GCTGTA";13;-1;-3;3;23;35
"GTAATG";14;2;8;7;4;35
"GTAGTG";10;-2;4;13;10;35
"GTCACT";9;18;6;-5;7;35
"GTCAGC";7;12;16;-6;6;35
"GTCCAA";8;13;7;-2;9;35
"GTCGCT";5;14;2;1;13;35
"GTCGGC";3;8;12;0;12;35
"GTCTAC";5;12;16;-4;6;35
"GTCTTA";13;9;3;-5;15;35
"TAAAGG";8;6;10;13;-2;35
"TAAGGG";4;2;6;19;4;35
"TAATAG";6;6;10;15;-2;35
"TACCCA";8;13;5;0;9;35
"TACTCC";5;12;14;-2;6;35
"TACTGA";7;13;5;1;9;35
"TATAAC";0;10;22;4;-1;35
"TATATA";8;7;9;3;8;35
"TATGAC";-4;6;18;10;5;35
"TATGTA";4;3;5;9;14;35
"TCACAT";7;9;11;2;6;35
"TCACTC";11;-1;17;-3;11;35
"TCATTT";12;5;7;-1;12;35
"TCTACG";17;1;5;5;7;35
"TCTGCG";13;-3;1;11;13;35
"TGAAAG";7;6;12;13;-3;35
"TGAGAG";3;2;8;19;3;35
"TGCACC";6;12;16;-4;5;35
"TGCAGA";8;13;7;-1;8;35
"TGCGCC";2;8;12;2;11;35
"TGCGGA";4;9;3;5;14;35
"TGCTAA";6;13;7;1;8;35
"TTCTCG";13;7;7;3;5;35
"TTTAAG";8;5;15;9;-2;35
"TTTGAG";4;1;11;15;4;35
"AAAAGT";4;17;7;6;2;36
"AAACAC";1;11;17;6;1;36
"AAACTA";9;8;4;5;10;36
"AAAGGT";0;13;3;12;8;36
"AAATAT";2;17;7;8;2;36
"AAATTC";6;7;13;3;7;36
"ACACCG";18;2;0;7;9;36
"ACATGG";17;2;0;8;9;36
"ACTACT";13;12;2;-2;11;36
"ACTAGC";11;6;12;-3;10;36
"ACTCAA";12;7;3;1;13;36
"ACTGCT";9;8;-2;4;17;36
"ACTGGC";7;2;8;3;16;36
"ACTTAC";9;6;12;-1;10;36
"ACTTTA";17;3;-1;-2;19;36
"AGAAAT";3;17;9;6;1;36
"AGAATC";7;7;15;1;6;36
"AGAGAT";-1;13;5;12;7;36
"AGAGTC";3;3;11;7;12;36
"ATACAG";9;6;10;11;0;36
"ATATTG";14;2;6;8;6;36
"ATCCCC";8;12;14;-6;8;36
"ATCCGA";10;13;5;-3;11;36
"ATCTCT";9;18;4;-4;9;36
"ATCTGC";7;12;14;-5;8;36
"ATTAAT";4;16;12;2;2;36
"ATTATC";8;6;18;-3;7;36
"ATTGAT";0;12;8;8;8;36
"ATTGTC";4;2;14;3;13;36
"CAAACC";0;7;16;14;-1;36
"CAAAGA";2;8;7;17;2;36
"CAAGCC";-4;3;12;20;5;36
"CAAGGA";-2;4;3;23;8;36
"CAATAA";0;8;7;19;2;36
"CAGATG";12;3;0;19;2;36
"CAGGTG";8;-1;-4;25;8;36
"CCTACA";11;3;2;9;11;36
"CCTGCA";7;-1;-2;15;17;36
"CGAAAA";1;8;9;17;1;36
"CGAGAA";-3;4;5;23;7;36
"CTAACG";8;2;9;19;-2;36
"CTAGCG";4;-2;5;25;4;36
"CTCTCA";7;9;4;7;9;36
"CTTAAA";2;7;12;13;2;36
"CTTGAA";-2;3;8;19;8;36
"GACCAT";7;22;1;0;6;36
"GACCTC";11;12;7;-5;11;36
"GACTTT";12;18;-3;-3;12;36
"GCCCGG";22;7;-6;0;13;36
"GGCATT";13;18;-1;-5;11;36
"GGCGTT";9;14;-5;1;17;36
"GTCCTG";19;7;0;0;10;36
"TACCGG";13;11;2;6;4;36
"TCGAAT";8;10;11;1;6;36
"TCGATC";12;0;17;-4;11;36
"TCGGAT";4;6;7;7;12;36
"TCGGTC";8;-4;13;2;17;36
"TGCCAG";12;11;4;6;3;36
"TGCTTG";17;7;0;3;9;36
"AACCGT";9;22;-1;-1;8;37
"AAGAAC";2;12;17;5;1;37
"AAGATA";10;9;4;4;10;37
"AAGGAC";-2;8;13;11;7;37
"AAGGTA";6;5;0;10;16;37
"ACGACG";19;3;0;6;9;37
"ACGGCG";15;-1;-4;12;15;37
"ACTCTG";23;1;-4;3;14;37
"AGCCAT";8;22;1;-1;7;37
"AGCCTC";12;12;7;-6;12;37
"AGCTTT";13;18;-3;-4;13;37
"ATAACA";6;8;13;4;6;37
"ATAGCA";2;4;9;10;12;37
"ATGAAG";10;7;10;10;0;37
"ATGGAG";6;3;6;16;6;37
"CAACAG";6;6;4;24;-3;37
"CAATTG";11;2;0;21;3;37
"CACCCC";5;12;8;7;5;37
"CACCGA";7;13;-1;10;8;37
"CACTCT";6;18;-2;9;6;37
"CACTGC";4;12;8;8;5;37
"CATAAT";1;16;6;15;-1;37
"CATATC";5;6;12;10;4;37
"CATGAT";-3;12;2;21;5;37
"CATGTC";1;2;8;16;10;37
"CCACTT";12;5;1;8;11;37
"CCTAGG";16;1;-1;15;6;37
"CCTGGG";12;-3;-5;21;12;37
"CCTTAG";14;1;-1;17;6;37
"CGAATG";12;2;2;19;2;37
"CGAGTG";8;-2;-2;25;8;37
"CGCACT";7;18;0;7;5;37
"CGCAGC";5;12;10;6;4;37
"CGCCAA";6;13;1;10;7;37
"CGCGCT";3;14;-4;13;11;37
"CGCGGC";1;8;6;12;10;37
"CGCTAC";3;12;10;8;4;37
"CGCTTA";11;9;-3;7;13;37
"CTCCCG";13;7;1;12;4;37
"CTCTGG";12;7;1;13;4;37
"CTTATG";13;1;5;15;3;37
"CTTGTG";9;-3;1;21;9;37
"GAAAAC";1;11;19;6;0;37
"GAAATA";9;8;6;5;9;37
"GAAGAC";-3;7;15;12;6;37
"GAAGTA";5;4;2;11;15;37
"GCAACG";18;2;2;7;8;37
"GCAGCG";14;-2;-2;13;14;37
"GCCTCA";17;9;-3;-5;19;37
"GCTAAA";12;7;5;1;12;37
"GCTGAA";8;3;1;7;18;37
"GTAAAG";9;6;12;11;-1;37
"GTAGAG";5;2;8;17;5;37
"GTCACC";8;12;16;-6;7;37
"GTCAGA";10;13;7;-3;10;37
"GTCGCC";4;8;12;0;13;37
"GTCGGA";6;9;3;3;16;37
"GTCTAA";8;13;7;-1;10;37
"TAAACG";9;6;10;13;-1;37
"TAAGCG";5;2;6;19;5;37
"TACTCA";8;13;5;1;10;37
"TATAAA";3;11;13;7;3;37
"TATGAA";-1;7;9;13;9;37
"TCAAGT";9;9;11;1;7;37
"TCACAC";6;3;21;1;6;37
"TCACTA";14;0;8;0;15;37
"TCAGGT";5;5;7;7;13;37
"TCATAT";7;9;11;3;7;37
"TCATTC";11;-1;17;-2;12;37
"TGCACA";9;13;7;-1;9;37
"TGCGCA";5;9;3;5;15;37
"TTAATT";6;9;17;1;4;37
"TTAGTT";2;5;13;7;10;37
"AAAACT";5;17;7;6;3;38
"AAAAGC";3;11;17;5;2;38
"AAACAA";4;12;8;9;5;38
"AAAGCT";1;13;3;12;9;38
"AAAGGC";-1;7;13;11;8;38
"AAATAC";1;11;17;7;2;38
"AAATTA";9;8;4;6;11;38
"ACATCG";18;2;0;8;10;38
"ACTACC";12;6;12;-3;11;38
"ACTAGA";14;7;3;0;14;38
"ACTGCC";8;2;8;3;17;38
"ACTGGA";10;3;-1;6;20;38
"ACTTAA";12;7;3;2;14;38
"AGAAAC";2;11;19;5;1;38
"AGAATA";10;8;6;4;10;38
"AGAGAC";-2;7;15;11;7;38
"AGAGTA";6;4;2;10;16;38
"ATAAGG";11;6;10;10;1;38
"ATAGGG";7;2;6;16;7;38
"ATATAG";9;6;10;12;1;38
"ATCCCA";11;13;5;-3;12;38
"ATCTCC";8;12;14;-5;9;38
"ATCTGA";10;13;5;-2;12;38
"ATTAAC";3;10;22;1;2;38
"ATTATA";11;7;9;0;11;38
"ATTGAC";-1;6;18;7;8;38
"ATTGTA";7;3;5;6;17;38
"CAAACA";3;8;7;17;3;38
"CAAGCA";-1;4;3;23;9;38
"CAGAAG";7;7;4;23;-3;38
"CAGGAG";3;3;0;29;3;38
"CCGATT";13;6;1;7;11;38
"CCGGTT";9;2;-3;13;17;38
"CGCCTG";17;7;-6;12;8;38
"GACAGT";9;22;1;-1;7;38
"GACCAC";6;16;11;-1;6;38
"GACCTA";14;13;-2;-2;15;38
"GACGGT";5;18;-3;5;13;38
"GACTAT";7;22;1;1;7;38
"GACTTC";11;12;7;-4;12;38
"GCCCCG";23;7;-6;0;14;38
"GCCTGG";22;7;-6;1;14;38
"GCTATG";23;1;-2;3;13;38
"GCTGTG";19;-3;-6;9;19;38
"GGCAAT";8;22;3;-1;6;38
"GGCATC";12;12;9;-6;11;38
"GGCGAT";4;18;-1;5;12;38
"GGCGTC";8;8;5;0;17;38
"GTCCAG";14;11;4;4;5;38
"GTCTTG";19;7;0;1;11;38
"TACCCG";14;11;2;6;5;38
"TACTGG";13;11;2;7;5;38
"TATATG";14;5;6;9;4;38
"TATGTG";10;1;2;15;10;38
"TCCCGT";14;14;3;-6;13;38
"TCGAAC";7;4;21;0;6;38
"TCGATA";15;1;8;-1;15;38
"TCGGAC";3;0;17;6;12;38
"TCGGTA";11;-3;4;5;21;38
"TGCAGG";14;11;4;5;4;38
"TGCGGG";10;7;0;11;10;38
"TGCTAG";12;11;4;7;4;38
"TTCCTT";11;14;9;-6;10;38
"AAACTG";15;6;1;11;6;39
"AACCCT";10;22;-1;-1;9;39
"AACCGC";8;16;9;-2;8;39
"AACTGT";9;22;-1;0;9;39
"AAGAAA";5;13;8;8;5;39
"AAGGAA";1;9;4;14;11;39
"AATATT";10;16;3;2;8;39
"AATGTT";6;12;-1;8;14;39
"ACTCAG";18;5;0;7;9;39
"ACTTTG";23;1;-4;4;15;39
"AGCAGT";10;22;1;-2;8;39
"AGCCAC";7;16;11;-2;7;39
"AGCCTA";15;13;-2;-3;16;39
"AGCGGT";6;18;-3;4;14;39
"AGCTAT";8;22;1;0;8;39
"AGCTTC";12;12;7;-5;13;39
"ATCCGG";16;11;2;3;7;39
"CAAAGG";8;6;4;23;-2;39
"CAAGGG";4;2;0;29;4;39
"CAATAG";6;6;4;25;-2;39
"CACCCA";8;13;-1;10;9;39
"CACTCC";5;12;8;8;6;39
"CACTGA";7;13;-1;11;9;39
"CATAAC";0;10;16;14;-1;39
"CATATA";8;7;3;13;8;39
"CATGAC";-4;6;12;20;5;39
"CATGTA";4;3;-1;19;14;39
"CCACAT";7;9;5;12;6;39
"CCACTC";11;-1;11;7;11;39
"CCATTT";12;5;1;9;12;39
"CCTACG";17;1;-1;15;7;39
"CCTGCG";13;-3;-5;21;13;39
"CGAAAG";7;6;6;23;-3;39
"CGAGAG";3;2;2;29;3;39
"CGCACC";6;12;10;6;5;39
"CGCAGA";8;13;1;9;8;39
"CGCGCC";2;8;6;12;11;39
"CGCGGA";4;9;-3;15;14;39
"CGCTAA";6;13;1;11;8;39
"CTCTCG";13;7;1;13;5;39
"CTTAAG";8;5;9;19;-2;39
"CTTGAG";4;1;5;25;4;39
"GAAAAA";4;12;10;9;4;39
"GAAGAA";0;8;6;15;10;39
"GTCACA";11;13;7;-3;11;39
"GTCGCA";7;9;3;3;17;39
"TCAACT";10;9;11;1;8;39
"TCAAGC";8;3;21;0;7;39
"TCACAA";9;4;12;4;10;39
"TCAGCT";6;5;7;7;14;39
"TCAGGC";4;-1;17;6;13;39
"TCATAC";6;3;21;2;7;39
"TCATTA";14;0;8;1;16;39
"TTAAAT";1;13;21;5;-1;39
"TTAATC";5;3;27;0;4;39
"TTAGAT";-3;9;17;11;5;39
"TTAGTC";1;-1;23;6;10;39
"AAAACC";4;11;17;5;3;40
"AAAAGA";6;12;8;8;6;40
"AAAGCC";0;7;13;11;9;40
"AAAGGA";2;8;4;14;12;40
"AAATAA";4;12;8;10;6;40
"AAGATG";16;7;1;10;6;40
"AAGGTG";12;3;-3;16;12;40
"ACTACA";15;7;3;0;15;40
"ACTGCA";11;3;-1;6;21;40
"AGAAAA";5;12;10;8;5;40
"AGAGAA";1;8;6;14;11;40
"ATAACG";12;6;10;10;2;40
"ATAGCG";8;2;6;16;8;40
"ATCTCA";11;13;5;-2;13;40
"ATTAAA";6;11;13;4;6;40
"ATTGAA";2;7;9;10;12;40
"CACCGG";13;11;-4;16;4;40
"CCGAAT";8;10;5;11;6;40
"CCGATC";12;0;11;6;11;40
"CCGGAT";4;6;1;17;12;40
"CCGGTC";8;-4;7;12;17;40
"CGCCAG";12;11;-2;16;3;40
"CGCTTG";17;7;-6;13;9;40
"GAAATG";15;6;3;11;5;40
"GAAGTG";11;2;-1;17;11;40
"GACACT";10;22;1;-1;8;40
"GACAGC";8;16;11;-2;7;40
"GACCAA";9;17;2;2;10;40
"GACGCT";6;18;-3;5;14;40
"GACGGC";4;12;7;4;13;40
"GACTAC";6;16;11;0;7;40
"GACTTA";14;13;-2;-1;16;40
"GCCTCG";23;7;-6;1;15;40
"GCTAAG";18;5;2;7;8;40
"GCTGAG";14;1;-2;13;14;40
"GGCAAC";7;16;13;-2;6;40
"GGCATA";15;13;0;-3;15;40
"GGCGAC";3;12;9;4;12;40
"GGCGTA";11;9;-4;3;21;40
"GTCAGG";16;11;4;3;6;40
"GTCGGG";12;7;0;9;12;40
"GTCTAG";14;11;4;5;6;40
"TACTCG";14;11;2;7;6;40
"TATAAG";9;9;10;13;-1;40
"TATGAG";5;5;6;19;5;40
"TCACTG";20;-2;5;6;11;40
"TCCCCT";15;14;3;-6;14;40
"TCCCGC";13;8;13;-7;13;40
"TCCTGT";14;14;3;-5;14;40
"TCGAAA";10;5;12;3;10;40
"TCGGAA";6;1;8;9;16;40
"TCTATT";15;8;7;-3;13;40
"TCTGTT";11;4;3;3;19;40
"TGCACG";15;11;4;5;5;40
"TGCGCG";11;7;0;11;11;40
"TTCCAT";6;18;13;-2;5;40
"TTCCTC";10;8;19;-7;10;40
"TTCTTT";11;14;9;-5;11;40
"AAACAG";10;10;5;15;1;41
"AAATTG";15;6;1;12;7;41
"AACCCC";9;16;9;-2;9;41
"AACCGA";11;17;0;1;12;41
"AACTCT";10;22;-1;0;10;41
"AACTGC";8;16;9;-1;9;41
"AATAAT";5;20;7;6;3;41
"AATATC";9;10;13;1;8;41
"AATGAT";1;16;3;12;9;41
"AATGTC";5;6;9;7;14;41
"ACACTT";16;9;2;-1;15;41
"ACTAGG";20;5;0;6;10;41
"ACTGGG";16;1;-4;12;16;41
"ACTTAG";18;5;0;8;10;41
"AGAATG";16;6;3;10;6;41
"AGAGTG";12;2;-1;16;12;41
"AGCACT";11;22;1;-2;9;41
"AGCAGC";9;16;11;-3;8;41
"AGCCAA";10;17;2;1;11;41
"AGCGCT";7;18;-3;4;15;41
"AGCGGC";5;12;7;3;14;41
"AGCTAC";7;16;11;-1;8;41
"AGCTTA";15;13;-2;-2;17;41
"ATCCCG";17;11;2;3;8;41
"ATCTGG";16;11;2;4;8;41
"ATTATG";17;5;6;6;7;41
"ATTGTG";13;1;2;12;13;41
"CAAACG";9;6;4;23;-1;41
"CAAGCG";5;2;0;29;5;41
"CACTCA";8;13;-1;11;10;41
"CATAAA";3;11;7;17;3;41
"CATGAA";-1;7;3;23;9;41
"CCAAGT";9;9;5;11;7;41
"CCACAC";6;3;15;11;6;41
"CCACTA";14;0;2;10;15;41
"CCAGGT";5;5;1;17;13;41
"CCATAT";7;9;5;13;7;41
"CCATTC";11;-1;11;8;12;41
"CGCACA";9;13;1;9;9;41
"CGCGCA";5;9;-3;15;15;41
"CTAATT";6;9;11;11;4;41
"CTAGTT";2;5;7;17;10;41
"GACCTG";20;11;-5;4;11;41
"TCAACC";9;3;21;0;8;41
"TCAAGA";11;4;12;3;11;41
"TCAGCC";5;-1;17;6;14;41
"TCAGGA";7;0;8;9;17;41
"TCATAA";9;4;12;5;11;41
"TCGATG";21;-1;5;5;11;41
"TCGGTG";17;-5;1;11;17;41
"TTAAAC";0;7;31;4;-1;41
"TTAATA";8;4;18;3;8;41
"TTAGAC";-4;3;27;10;5;41
"TTAGTA";4;0;14;9;14;41
"AAAACA";7;12;8;8;7;42
"AAAGCA";3;8;4;14;13;42
"AAGAAG";11;11;5;14;1;42
"AAGGAG";7;7;1;20;7;42
"ACGATT";17;10;2;-2;15;42
"ACGGTT";13;6;-2;4;21;42
"AGCCTG";21;11;-5;3;12;42
"CACCCG";14;11;-4;16;5;42
"CACTGG";13;11;-4;17;5;42
"CATATG";14;5;0;19;4;42
"CATGTG";10;1;-4;25;10;42
"CCCCGT";14;14;-3;4;13;42
"CCGAAC";7;4;15;10;6;42
"CCGATA";15;1;2;9;15;42
"CCGGAC";3;0;11;16;12;42
"CCGGTA";11;-3;-2;15;21;42
"CGCAGG";14;11;-2;15;4;42
"CGCGGG";10;7;-6;21;10;42
"CGCTAG";12;11;-2;17;4;42
"CTCCTT";11;14;3;4;10;42
"GAAAAG";10;10;7;15;0;42
"GAAGAG";6;6;3;21;6;42
"GACACC";9;16;11;-2;8;42
"GACAGA";11;17;2;1;11;42
"GACGCC";5;12;7;4;14;42
"GACGGA";7;13;-2;7;17;42
"GACTAA";9;17;2;3;11;42
"GCAATT";16;9;4;-1;14;42
"GCAGTT";12;5;0;5;20;42
"GGCAAA";10;17;4;1;10;42
"GGCGAA";6;13;0;7;16;42
"GTCACG";17;11;4;3;7;42
"GTCGCG";13;7;0;9;13;42
"TAAATT";7;13;12;5;5;42
"TAAGTT";3;9;8;11;11;42
"TCACAG";15;2;9;10;6;42
"TCATTG";20;-2;5;7;12;42
"TCCCCC";14;8;13;-7;14;42
"TCCCGA";16;9;4;-4;17;42
"TCCTCT";15;14;3;-5;15;42
"TCCTGC";13;8;13;-6;14;42
"TCTAAT";10;12;11;1;8;42
"TCTATC";14;2;17;-4;13;42
"TCTGAT";6;8;7;7;14;42
"TCTGTC";10;-2;13;2;19;42
"TTCAGT";8;18;13;-3;6;42
"TTCCAC";5;12;23;-3;5;42
"TTCCTA";13;9;10;-4;14;42
"TTCGGT";4;14;9;3;12;42
"TTCTAT";6;18;13;-1;6;42
"TTCTTC";10;8;19;-6;11;42
"AAAAGG";12;10;5;14;2;43
"AAAGGG";8;6;1;20;8;43
"AAATAG";10;10;5;16;2;43
"AACCCA";12;17;0;1;13;43
"AACTCC";9;16;9;-1;10;43
"AACTGA";11;17;0;2;13;43
"AATAAC";4;14;17;5;3;43
"AATATA";12;11;4;4;12;43
"AATGAC";0;10;13;11;9;43
"AATGTA";8;7;0;10;18;43
"ACACAT";11;13;6;3;10;43
"ACACTC";15;3;12;-2;15;43
"ACATTT";16;9;2;0;16;43
"ACTACG";21;5;0;6;11;43
"ACTGCG";17;1;-4;12;17;43
"AGAAAG";11;10;7;14;1;43
"AGAGAG";7;6;3;20;7;43
"AGCACC";10;16;11;-3;9;43
"AGCAGA";12;17;2;0;12;43
"AGCGCC";6;12;7;3;15;43
"AGCGGA";8;13;-2;6;18;43
"AGCTAA";10;17;2;2;12;43
"ATCTCG";17;11;2;4;9;43
"ATTAAG";12;9;10;10;2;43
"ATTGAG";8;5;6;16;8;43
"CCAACT";10;9;5;11;8;43
"CCAAGC";8;3;15;10;7;43
"CCACAA";9;4;6;14;10;43
"CCAGCT";6;5;1;17;14;43
"CCAGGC";4;-1;11;16;13;43
"CCATAC";6;3;15;12;7;43
"CCATTA";14;0;2;11;16;43
"CTAAAT";1;13;15;15;-1;43
"CTAATC";5;3;21;10;4;43
"CTAGAT";-3;9;11;21;5;43
"CTAGTC";1;-1;17;16;10;43
"GACCAG";15;15;-1;8;6;43
"GACTTG";20;11;-5;5;12;43
"GCCCTT";21;14;-4;-8;20;43
"GGCATG";21;11;-3;3;11;43
"GGCGTG";17;7;-7;9;17;43
"TACCTT";12;18;4;-2;11;43
"TCAACA";12;4;12;3;12;43
"TCAGCA";8;0;8;9;18;43
"TCGAAG";16;3;9;9;6;43
"TCGGAG";12;-1;5;15;12;43
"TTAAAA";3;8;22;7;3;43
"TTAGAA";-1;4;18;13;9;43
"AACCGG";17;15;-3;7;8;44
"ACGAAT";12;14;6;2;10;44
"ACGATC";16;4;12;-3;15;44
"ACGGAT";8;10;2;8;16;44
"ACGGTC";12;0;8;3;21;44
"AGCCAG";16;15;-1;7;7;44
"AGCTTG";21;11;-5;4;13;44
"CACTCG";14;11;-4;17;6;44
"CATAAG";9;9;4;23;-1;44
"CATGAG";5;5;0;29;5;44
"CCACTG";20;-2;-1;16;11;44
"CCCCCT";15;14;-3;4;14;44
"CCCCGC";13;8;7;3;13;44
"CCCTGT";14;14;-3;5;14;44
"CCGAAA";10;5;6;13;10;44
"CCGGAA";6;1;2;19;16;44
"CCTATT";15;8;1;7;13;44
"CCTGTT";11;4;-3;13;19;44
"CGCACG";15;11;-2;15;5;44
"CGCGCG";11;7;-6;21;11;44
"CTCCAT";6;18;7;8;5;44
"CTCCTC";10;8;13;3;10;44
"CTCTTT";11;14;3;5;11;44
"GACACA";12;17;2;1;12;44
"GACGCA";8;13;-2;7;18;44
"GCAAAT";11;13;8;3;9;44
"GCAATC";15;3;14;-2;14;44
"GCAGAT";7;9;4;9;15;44
"GCAGTC";11;-1;10;4;20;44
"TAAAAT";2;17;16;9;0;44
"TAAATC";6;7;22;4;5;44
"TAAGAT";-2;13;12;15;6;44
"TAAGTC";2;3;18;10;11;44
"TCAAGG";17;2;9;9;7;44
"TCAGGG";13;-2;5;15;13;44
"TCATAG";15;2;9;11;7;44
"TCCCCA";17;9;4;-4;18;44
"TCCTCC";14;8;13;-6;15;44
"TCCTGA";16;9;4;-3;18;44
"TCTAAC";9;6;21;0;8;44
"TCTATA";17;3;8;-1;17;44
"TCTGAC";5;2;17;6;14;44
"TCTGTA";13;-1;4;5;23;44
"TTAATG";14;2;15;9;4;44
"TTAGTG";10;-2;11;15;10;44
"TTCACT";9;18;13;-3;7;44
"TTCAGC";7;12;23;-4;6;44
"TTCCAA";8;13;14;0;9;44
"TTCGCT";5;14;9;3;13;44
"TTCGGC";3;8;19;2;12;44
"TTCTAC";5;12;23;-2;6;44
"TTCTTA";13;9;10;-3;15;44
"AAAACG";13;10;5;14;3;45
"AAAGCG";9;6;1;20;9;45
"AACTCA";12;17;0;2;14;45
"AATAAA";7;15;8;8;7;45
"AATGAA";3;11;4;14;13;45
"ACAAGT";13;13;6;2;11;45
"ACACAC";10;7;16;2;10;45
"ACACTA";18;4;3;1;19;45
"ACAGGT";9;9;2;8;17;45
"ACATAT";11;13;6;4;11;45
"ACATTC";15;3;12;-1;16;45
"AGCACA";13;17;2;0;13;45
"AGCGCA";9;13;-2;6;19;45
"ATAATT";10;13;12;2;8;45
"ATAGTT";6;9;8;8;14;45
"CCAACC";9;3;15;10;8;45
"CCAAGA";11;4;6;13;11;45
"CCAGCC";5;-1;11;16;14;45
"CCAGGA";7;0;2;19;17;45
"CCATAA";9;4;6;15;11;45
"CCGATG";21;-1;-1;15;11;45
"CCGGTG";17;-5;-5;21;17;45
"CTAAAC";0;7;25;14;-1;45
"CTAATA";8;4;12;13;8;45
"CTAGAC";-4;3;21;20;5;45
"CTAGTA";4;0;8;19;14;45
"GACAGG";17;15;-1;7;7;45
"GACGGG";13;11;-5;13;13;45
"GACTAG";15;15;-1;9;7;45
"GCCCAT";16;18;0;-4;15;45
"GCCCTC";20;8;6;-9;20;45
"GCCTTT";21;14;-4;-7;21;45
"GGCAAG";16;15;1;7;6;45
"GGCGAG";12;11;-3;13;12;45
"TACCAT";7;22;8;2;6;45
"TACCTC";11;12;14;-3;11;45
"TACTTT";12;18;4;-1;12;45
"TCCCGG";22;7;1;2;13;45
"TGCATT";13;18;6;-3;11;45
"TGCGTT";9;14;2;3;17;45
"TTCCTG";19;7;7;2;10;45
"AACCCG";18;15;-3;7;9;46
"AACTGG";17;15;-3;8;9;46
"AATATG";18;9;1;10;8;46
"AATGTG";14;5;-3;16;14;46
"ACCCGT";18;18;-2;-5;17;46
"ACGAAC";11;8;16;1;10;46
"ACGATA";19;5;3;0;19;46
"ACGGAC";7;4;12;7;16;46
"ACGGTA";15;1;-1;6;25;46
"AGCAGG";18;15;-1;6;8;46
"AGCGGG";14;11;-5;12;14;46
"AGCTAG";16;15;-1;8;8;46
"ATCCTT";15;18;4;-5;14;46
"CAAATT";7;13;6;15;5;46
"CAAGTT";3;9;2;21;11;46
"CCACAG";15;2;3;20;6;46
"CCATTG";20;-2;-1;17;12;46
"CCCCCC";14;8;7;3;14;46
"CCCCGA";16;9;-2;6;17;46
"CCCTCT";15;14;-3;5;15;46
"CCCTGC";13;8;7;4;14;46
"CCTAAT";10;12;5;11;8;46
"CCTATC";14;2;11;6;13;46
"CCTGAT";6;8;1;17;14;46
"CCTGTC";10;-2;7;12;19;46
"CTCAGT";8;18;7;7;6;46
"CTCCAC";5;12;17;7;5;46
"CTCCTA";13;9;4;6;14;46
"CTCGGT";4;14;3;13;12;46
"CTCTAT";6;18;7;9;6;46
"CTCTTC";10;8;13;4;11;46
"GCAAAC";10;7;18;2;9;46
"GCAATA";18;4;5;1;18;46
"GCAGAC";6;3;14;8;15;46
"GCAGTA";14;0;1;7;24;46
"TAAAAC";1;11;26;8;0;46
"TAAATA";9;8;13;7;9;46
"TAAGAC";-3;7;22;14;6;46
"TAAGTA";5;4;9;13;15;46
"TCAACG";18;2;9;9;8;46
"TCAGCG";14;-2;5;15;14;46
"TCCTCA";17;9;4;-3;19;46
"TCTAAA";12;7;12;3;12;46
"TCTGAA";8;3;8;9;18;46
"TTAAAG";9;6;19;13;-1;46
"TTAGAG";5;2;15;19;5;46
"TTCACC";8;12;23;-4;7;46
"TTCAGA";10;13;14;-1;10;46
"TTCGCC";4;8;19;2;13;46
"TTCGGA";6;9;10;5;16;46
"TTCTAA";8;13;14;1;10;46
"ACAACT";14;13;6;2;12;47
"ACAAGC";12;7;16;1;11;47
"ACACAA";13;8;7;5;14;47
"ACAGCT";10;9;2;8;18;47
"ACAGGC";8;3;12;7;17;47
"ACATAC";10;7;16;3;11;47
"ACATTA";18;4;3;2;20;47
"ATAAAT";5;17;16;6;3;47
"ATAATC";9;7;22;1;8;47
"ATAGAT";1;13;12;12;9;47
"ATAGTC";5;3;18;7;14;47
"CACCTT";12;18;-2;8;11;47
"CCAACA";12;4;6;13;12;47
"CCAGCA";8;0;2;19;18;47
"CCGAAG";16;3;3;19;6;47
"CCGGAG";12;-1;-1;25;12;47
"CTAAAA";3;8;16;17;3;47
"CTAGAA";-1;4;12;23;9;47
"GACACG";18;15;-1;7;8;47
"GACGCG";14;11;-5;13;14;47
"GCCAGT";18;18;0;-5;16;47
"GCCCAC";15;12;10;-5;15;47
"GCCCTA";23;9;-3;-6;24;47
"GCCGGT";14;14;-4;1;22;47
"GCCTAT";16;18;0;-3;16;47
"GCCTTC";20;8;6;-8;21;47
"GTCATT";15;18;6;-5;13;47
"GTCGTT";11;14;2;1;19;47
"TACAGT";9;22;8;1;7;47
"TACCAC";6;16;18;1;6;47
"TACCTA";14;13;5;0;15;47
"TACGGT";5;18;4;7;13;47
"TACTAT";7;22;8;3;7;47
"TACTTC";11;12;14;-2;12;47
"TCCCCG";23;7;1;2;14;47
"TCCTGG";22;7;1;3;14;47
"TCTATG";23;1;5;5;13;47
"TCTGTG";19;-3;1;11;19;47
"TGCAAT";8;22;10;1;6;47
"TGCATC";12;12;16;-4;11;47
"TGCGAT";4;18;6;7;12;47
"TGCGTC";8;8;12;2;17;47
"TTCCAG";14;11;11;6;5;47
"TTCTTG";19;7;7;3;11;47
"AACTCG";18;15;-3;8;10;48
"AATAAG";13;13;5;14;3;48
"AATGAG";9;9;1;20;9;48
"ACACTG";24;2;0;7;15;48
"ACCCCT";19;18;-2;-5;18;48
"ACCCGC";17;12;8;-6;17;48
"ACCTGT";18;18;-2;-4;18;48
"ACGAAA";14;9;7;4;14;48
"ACGGAA";10;5;3;10;20;48
"ACTATT";19;12;2;-2;17;48
"ACTGTT";15;8;-2;4;23;48
"AGCACG";19;15;-1;6;9;48
"AGCGCG";15;11;-5;12;15;48
"ATCCAT";10;22;8;-1;9;48
"ATCCTC";14;12;14;-6;14;48
"ATCTTT";15;18;4;-4;15;48
"CAAAAT";2;17;10;19;0;48
"CAAATC";6;7;16;14;5;48
"CAAGAT";-2;13;6;25;6;48
"CAAGTC";2;3;12;20;11;48
"CCAAGG";17;2;3;19;7;48
"CCAGGG";13;-2;-1;25;13;48
"CCATAG";15;2;3;21;7;48
"CCCCCA";17;9;-2;6;18;48
"CCCTCC";14;8;7;4;15;48
"CCCTGA";16;9;-2;7;18;48
"CCTAAC";9;6;15;10;8;48
"CCTATA";17;3;2;9;17;48
"CCTGAC";5;2;11;16;14;48
"CCTGTA";13;-1;-2;15;23;48
"CTAATG";14;2;9;19;4;48
"CTAGTG";10;-2;5;25;10;48
"CTCACT";9;18;7;7;7;48
"CTCAGC";7;12;17;6;6;48
"CTCCAA";8;13;8;10;9;48
"CTCGCT";5;14;3;13;13;48
"CTCGGC";3;8;13;12;12;48
"CTCTAC";5;12;17;8;6;48
"CTCTTA";13;9;4;7;15;48
"GCAAAA";13;8;9;5;13;48
"GCAGAA";9;4;5;11;19;48
"TAAAAA";4;12;17;11;4;48
"TAAGAA";0;8;13;17;10;48
"TTCACA";11;13;14;-1;11;48
"TTCGCA";7;9;10;5;17;48
"ACAACC";13;7;16;1;12;49
"ACAAGA";15;8;7;4;15;49
"ACAGCC";9;3;12;7;18;49
"ACAGGA";11;4;3;10;21;49
"ACATAA";13;8;7;6;15;49
"ACGATG";25;3;0;6;15;49
"ACGGTG";21;-1;-4;12;21;49
"ATAAAC";4;11;26;5;3;49
"ATAATA";12;8;13;4;12;49
"ATAGAC";0;7;22;11;9;49
"ATAGTA";8;4;9;10;18;49
"CACCAT";7;22;2;12;6;49
"CACCTC";11;12;8;7;11;49
"CACTTT";12;18;-2;9;12;49
"CCCCGG";22;7;-5;12;13;49
"CGCATT";13;18;0;7;11;49
"CGCGTT";9;14;-4;13;17;49
"CTCCTG";19;7;1;12;10;49
"GCAATG";24;2;2;7;14;49
"GCAGTG";20;-2;-2;13;20;49
"GCCACT";19;18;0;-5;17;49
"GCCAGC";17;12;10;-6;16;49
"GCCCAA";18;13;1;-2;19;49
"GCCGCT";15;14;-4;1;23;49
"GCCGGC";13;8;6;0;22;49
"GCCTAC";15;12;10;-4;16;49
"GCCTTA";23;9;-3;-5;25;49
"GTCAAT";10;22;10;-1;8;49
"GTCATC";14;12;16;-6;13;49
"GTCGAT";6;18;6;5;14;49
"GTCGTC";10;8;12;0;19;49
"TAAATG";15;6;10;13;5;49
"TAAGTG";11;2;6;19;11;49
"TACACT";10;22;8;1;8;49
"TACAGC";8;16;18;0;7;49
"TACCAA";9;17;9;4;10;49
"TACGCT";6;18;4;7;14;49
"TACGGC";4;12;14;6;13;49
"TACTAC";6;16;18;2;7;49
"TACTTA";14;13;5;1;16;49
"TCCTCG";23;7;1;3;15;49
"TCTAAG";18;5;9;9;8;49
"TCTGAG";14;1;5;15;14;49
"TGCAAC";7;16;20;0;6;49
"TGCATA";15;13;7;-1;15;49
"TGCGAC";3;12;16;6;12;49
"TGCGTA";11;9;3;5;21;49
"TTCAGG";16;11;11;5;6;49
"TTCGGG";12;7;7;11;12;49
"TTCTAG";14;11;11;7;6;49
"AAAATT";11;17;7;6;9;50
"AAAGTT";7;13;3;12;15;50
"ACACAG";19;6;4;11;10;50
"ACATTG";24;2;0;8;16;50
"ACCCCC";18;12;8;-6;18;50
"ACCCGA";20;13;-1;-3;21;50
"ACCTCT";19;18;-2;-4;19;50
"ACCTGC";17;12;8;-5;18;50
"ACTAAT";14;16;6;2;12;50
"ACTATC";18;6;12;-3;17;50
"ACTGAT";10;12;2;8;18;50
"ACTGTC";14;2;8;3;23;50
"ATCAGT";12;22;8;-2;10;50
"ATCCAC";9;16;18;-2;9;50
"ATCCTA";17;13;5;-3;18;50
"ATCGGT";8;18;4;4;16;50
"ATCTAT";10;22;8;0;10;50
"ATCTTC";14;12;14;-5;15;50
"CAAAAC";1;11;20;18;0;50
"CAAATA";9;8;7;17;9;50
"CAAGAC";-3;7;16;24;6;50
"CAAGTA";5;4;3;23;15;50
"CCAACG";18;2;3;19;8;50
"CCAGCG";14;-2;-1;25;14;50
"CCCTCA";17;9;-2;7;19;50
"CCTAAA";12;7;6;13;12;50
"CCTGAA";8;3;2;19;18;50
"CTAAAG";9;6;13;23;-1;50
"CTAGAG";5;2;9;29;5;50
"CTCACC";8;12;17;6;7;50
"CTCAGA";10;13;8;9;10;50
"CTCGCC";4;8;13;12;13;50
"CTCGGA";6;9;4;15;16;50
"CTCTAA";8;13;8;11;10;50
"GCCCTG";29;7;-6;0;20;50
"TACCTG";20;11;2;6;11;50
"AACCTT";16;22;-1;-1;15;51
"ACAACA";16;8;7;4;16;51
"ACAGCA";12;4;3;10;22;51
"ACGAAG";20;7;4;10;10;51
"ACGGAG";16;3;0;16;16;51
"ATAAAA";7;12;17;8;7;51
"ATAGAA";3;8;13;14;13;51
"CACAGT";9;22;2;11;7;51
"CACCAC";6;16;12;11;6;51
"CACCTA";14;13;-1;10;15;51
"CACGGT";5;18;-2;17;13;51
"CACTAT";7;22;2;13;7;51
"CACTTC";11;12;8;8;12;51
"CCCCCG";23;7;-5;12;14;51
"CCCTGG";22;7;-5;13;14;51
"CCTATG";23;1;-1;15;13;51
"CCTGTG";19;-3;-5;21;19;51
"CGCAAT";8;22;4;11;6;51
"CGCATC";12;12;10;6;11;51
"CGCGAT";4;18;0;17;12;51
"CGCGTC";8;8;6;12;17;51
"CTCCAG";14;11;5;16;5;51
"CTCTTG";19;7;1;13;11;51
"GCAAAG";19;6;6;11;9;51
"GCAGAG";15;2;2;17;15;51
"GCCACC";18;12;10;-6;17;51
"GCCAGA";20;13;1;-3;20;51
"GCCGCC";14;8;6;0;23;51
"GCCGGA";16;9;-3;3;26;51
"GCCTAA";18;13;1;-1;20;51
"GTCAAC";9;16;20;-2;8;51
"GTCATA";17;13;7;-3;17;51
"GTCGAC";5;12;16;4;14;51
"GTCGTA";13;9;3;3;23;51
"TAAAAG";10;10;14;17;0;51
"TAAGAG";6;6;10;23;6;51
"TACACC";9;16;18;0;8;51
"TACAGA";11;17;9;3;11;51
"TACGCC";5;12;14;6;14;51
"TACGGA";7;13;5;9;17;51
"TACTAA";9;17;9;5;11;51
"TCAATT";16;9;11;1;14;51
"TCAGTT";12;5;7;7;20;51
"TGCAAA";10;17;11;3;10;51
"TGCGAA";6;13;7;9;16;51
"TTCACG";17;11;11;5;7;51
"TTCGCG";13;7;7;11;13;51
"AAAAAT";6;21;11;10;4;52
"AAAATC";10;11;17;5;9;52
"AAAGAT";2;17;7;16;10;52
"AAAGTC";6;7;13;11;15;52
"ACAAGG";21;6;4;10;11;52
"ACAGGG";17;2;0;16;17;52
"ACATAG";19;6;4;12;11;52
"ACCCCA";21;13;-1;-3;22;52
"ACCTCC";18;12;8;-5;19;52
"ACCTGA";20;13;-1;-2;22;52
"ACTAAC";13;10;16;1;12;52
"ACTATA";21;7;3;0;21;52
"ACTGAC";9;6;12;7;18;52
"ACTGTA";17;3;-1;6;27;52
"ATAATG";18;6;10;10;8;52
"ATAGTG";14;2;6;16;14;52
"ATCACT";13;22;8;-2;11;52
"ATCAGC";11;16;18;-3;10;52
"ATCCAA";12;17;9;1;13;52
"ATCGCT";9;18;4;4;17;52
"ATCGGC";7;12;14;3;16;52
"ATCTAC";9;16;18;-1;10;52
"ATCTTA";17;13;5;-2;19;52
"CAAAAA";4;12;11;21;4;52
"CAAGAA";0;8;7;27;10;52
"CTCACA";11;13;8;9;11;52
"CTCGCA";7;9;4;15;17;52
"GACATT";16;22;1;-1;14;52
"GACGTT";12;18;-3;5;20;52
"GCCCAG";24;11;-2;4;15;52
"GCCTTG";29;7;-6;1;21;52
"TACCAG";15;15;6;10;6;52
"TACTTG";20;11;2;7;12;52
"TCCCTT";21;14;3;-6;20;52
"TGCATG";21;11;4;5;11;52
"TGCGTG";17;7;0;11;17;52
"AACCAT";11;26;3;3;10;53
"AACCTC";15;16;9;-2;15;53
"AACTTT";16;22;-1;0;16;53
"ACCCGG";26;11;-4;3;17;53
"AGCATT";17;22;1;-2;15;53
"AGCGTT";13;18;-3;4;21;53
"ATCCTG";23;11;2;3;14;53
"CAAATG";15;6;4;23;5;53
"CAAGTG";11;2;0;29;11;53
"CACACT";10;22;2;11;8;53
"CACAGC";8;16;12;10;7;53
"CACCAA";9;17;3;14;10;53
"CACGCT";6;18;-2;17;14;53
"CACGGC";4;12;8;16;13;53
"CACTAC";6;16;12;12;7;53
"CACTTA";14;13;-1;11;16;53
"CCCTCG";23;7;-5;13;15;53
"CCTAAG";18;5;3;19;8;53
"CCTGAG";14;1;-1;25;14;53
"CGCAAC";7;16;14;10;6;53
"CGCATA";15;13;1;9;15;53
"CGCGAC";3;12;10;16;12;53
"CGCGTA";11;9;-3;15;21;53
"CTCAGG";16;11;5;15;6;53
"CTCGGG";12;7;1;21;12;53
"CTCTAG";14;11;5;17;6;53
"GCCACA";21;13;1;-3;21;53
"GCCGCA";17;9;-3;3;27;53
"GTCAAA";12;17;11;1;12;53
"GTCGAA";8;13;7;7;18;53
"TACACA";12;17;9;3;12;53
"TACGCA";8;13;5;9;18;53
"TCAAAT";11;13;15;5;9;53
"TCAATC";15;3;21;0;14;53
"TCAGAT";7;9;11;11;15;53
"TCAGTC";11;-1;17;6;20;53
"AAAAAC";5;15;21;9;4;54
"AAAATA";13;12;8;8;13;54
"AAAGAC";1;11;17;15;10;54
"AAAGTA";9;8;4;14;19;54
"ACAACG";22;6;4;10;12;54
"ACAGCG";18;2;0;16;18;54
"ACCTCA";21;13;-1;-2;23;54
"ACTAAA";16;11;7;4;16;54
"ACTGAA";12;7;3;10;22;54
"ATAAAG";13;10;14;14;3;54
"ATAGAG";9;6;10;20;9;54
"ATCACC";12;16;18;-3;11;54
"ATCAGA";14;17;9;0;14;54
"ATCGCC";8;12;14;3;17;54
"ATCGGA";10;13;5;6;20;54
"ATCTAA";12;17;9;2;14;54
"CACCTG";20;11;-4;16;11;54
"GACAAT";11;26;5;3;9;54
"GACATC";15;16;11;-2;14;54
"GACGAT";7;22;1;9;15;54
"GACGTC";11;12;7;4;20;54
"GCCAGG";26;11;-2;3;16;54
"GCCGGG";22;7;-6;9;22;54
"GCCTAG";24;11;-2;5;16;54
"GTCATG";23;11;4;3;13;54
"GTCGTG";19;7;0;9;19;54
"TACAGG";17;15;6;9;7;54
"TACGGG";13;11;2;15;13;54
"TACTAG";15;15;6;11;7;54
"TCCCAT";16;18;7;-2;15;54
"TCCCTC";20;8;13;-7;20;54
"TCCTTT";21;14;3;-5;21;54
"TGCAAG";16;15;8;9;6;54
"TGCGAG";12;11;4;15;12;54
"AACAGT";13;26;3;2;11;55
"AACCAC";10;20;13;2;10;55
"AACCTA";18;17;0;1;19;55
"AACGGT";9;22;-1;8;17;55
"AACTAT";11;26;3;4;11;55
"AACTTC";15;16;9;-1;16;55
"ACCCCG";27;11;-4;3;18;55
"ACCTGG";26;11;-4;4;18;55
"ACTATG";27;5;0;6;17;55
"ACTGTG";23;1;-4;12;23;55
"AGCAAT";12;26;5;2;10;55
"AGCATC";16;16;11;-3;15;55
"AGCGAT";8;22;1;8;16;55
"AGCGTC";12;12;7;3;21;55
"ATCCAG";18;15;6;7;9;55
"ATCTTG";23;11;2;4;15;55
"CAAAAG";10;10;8;27;0;55
"CAAGAG";6;6;4;33;6;55
"CACACC";9;16;12;10;8;55
"CACAGA";11;17;3;13;11;55
"CACGCC";5;12;8;16;14;55
"CACGGA";7;13;-1;19;17;55
"CACTAA";9;17;3;15;11;55
"CCAATT";16;9;5;11;14;55
"CCAGTT";12;5;1;17;20;55
"CGCAAA";10;17;5;13;10;55
"CGCGAA";6;13;1;19;16;55
"CTCACG";17;11;5;15;7;55
"CTCGCG";13;7;1;21;13;55
"TCAAAC";10;7;25;4;9;55
"TCAATA";18;4;12;3;18;55
"TCAGAC";6;3;21;10;15;55
"TCAGTA";14;0;8;9;24;55
"AAAAAA";8;16;12;12;8;56
"AAAGAA";4;12;8;18;14;56
"ATCACA";15;17;9;0;15;56
"ATCGCA";11;13;5;6;21;56
"CACCAG";15;15;0;20;6;56
"CACTTG";20;11;-4;17;12;56
"CCCCTT";21;14;-3;4;20;56
"CGCATG";21;11;-2;15;11;56
"CGCGTG";17;7;-6;21;17;56
"GACAAC";10;20;15;2;9;56
"GACATA";18;17;2;1;18;56
"GACGAC";6;16;11;8;15;56
"GACGTA";14;13;-2;7;24;56
"GCCACG";27;11;-2;3;17;56
"GCCGCG";23;7;-6;9;23;56
"GTCAAG";18;15;8;7;8;56
"GTCGAG";14;11;4;13;14;56
"TACACG";18;15;6;9;8;56
"TACGCG";14;11;2;15;14;56
"TCCAGT";18;18;7;-3;16;56
"TCCCAC";15;12;17;-3;15;56
"TCCCTA";23;9;4;-4;24;56
"TCCGGT";14;14;3;3;22;56
"TCCTAT";16;18;7;-1;16;56
"TCCTTC";20;8;13;-6;21;56
"TTCATT";15;18;13;-3;13;56
"TTCGTT";11;14;9;3;19;56
"AAAATG";19;10;5;14;9;57
"AAAGTG";15;6;1;20;15;57
"AACACT";14;26;3;2;12;57
"AACAGC";12;20;13;1;11;57
"AACCAA";13;21;4;5;14;57
"AACGCT";10;22;-1;8;18;57
"AACGGC";8;16;9;7;17;57
"AACTAC";10;20;13;3;11;57
"AACTTA";18;17;0;2;20;57
"ACCTCG";27;11;-4;4;19;57
"ACTAAG";22;9;4;10;12;57
"ACTGAG";18;5;0;16;18;57
"AGCAAC";11;20;15;1;10;57
"AGCATA";19;17;2;0;19;57
"AGCGAC";7;16;11;7;16;57
"AGCGTA";15;13;-2;6;25;57
"ATCAGG";20;15;6;6;10;57
"ATCGGG";16;11;2;12;16;57
"ATCTAG";18;15;6;8;10;57
"CACACA";12;17;3;13;12;57
"CACGCA";8;13;-1;19;18;57
"CCAAAT";11;13;9;15;9;57
"CCAATC";15;3;15;10;14;57
"CCAGAT";7;9;5;21;15;57
"CCAGTC";11;-1;11;16;20;57
"TCAAAA";13;8;16;7;13;57
"TCAGAA";9;4;12;13;19;57
"AACCTG";24;15;-3;7;15;58
"CACAGG";17;15;0;19;7;58
"CACGGG";13;11;-4;25;13;58
"CACTAG";15;15;0;21;7;58
"CCCCAT";16;18;1;8;15;58
"CCCCTC";20;8;7;3;20;58
"CCCTTT";21;14;-3;5;21;58
"CGCAAG";16;15;2;19;6;58
"CGCGAG";12;11;-2;25;12;58
"GACAAA";13;21;6;5;13;58
"GACGAA";9;17;2;11;19;58
"TCAATG";24;2;9;9;14;58
"TCAGTG";20;-2;5;15;20;58
"TCCACT";19;18;7;-3;17;58
"TCCAGC";17;12;17;-4;16;58
"TCCCAA";18;13;8;0;19;58
"TCCGCT";15;14;3;3;23;58
"TCCGGC";13;8;13;2;22;58
"TCCTAC";15;12;17;-2;16;58
"TCCTTA";23;9;4;-3;25;58
"TTCAAT";10;22;17;1;8;58
"TTCATC";14;12;23;-4;13;58
"TTCGAT";6;18;13;7;14;58
"TTCGTC";10;8;19;2;19;58
"AAAAAG";14;14;9;18;4;59
"AAAGAG";10;10;5;24;10;59
"AACACC";13;20;13;1;12;59
"AACAGA";15;21;4;4;15;59
"AACGCC";9;16;9;7;18;59
"AACGGA";11;17;0;10;21;59
"AACTAA";13;21;4;6;15;59
"ACAATT";20;13;6;2;18;59
"ACAGTT";16;9;2;8;24;59
"AGCAAA";14;21;6;4;14;59
"AGCGAA";10;17;2;10;20;59
"ATCACG";21;15;6;6;11;59
"ATCGCG";17;11;2;12;17;59
"CCAAAC";10;7;19;14;9;59
"CCAATA";18;4;6;13;18;59
"CCAGAC";6;3;15;20;15;59
"CCAGTA";14;0;2;19;24;59
"GACATG";24;15;-1;7;14;59
"GACGTG";20;11;-5;13;20;59
"TCCCTG";29;7;1;2;20;59
"AACCAG";19;19;1;11;10;60
"AACTTG";24;15;-3;8;16;60
"ACCCTT";25;18;-2;-5;24;60
"AGCATG";25;15;-1;6;15;60
"AGCGTG";21;11;-5;12;21;60
"CACACG";18;15;0;19;8;60
"CACGCG";14;11;-4;25;14;60
"CCCAGT";18;18;1;7;16;60
"CCCCAC";15;12;11;7;15;60
"CCCCTA";23;9;-2;6;24;60
"CCCGGT";14;14;-3;13;22;60
"CCCTAT";16;18;1;9;16;60
"CCCTTC";20;8;7;4;21;60
"CTCATT";15;18;7;7;13;60
"CTCGTT";11;14;3;13;19;60
"TCAAAG";19;6;13;13;9;60
"TCAGAG";15;2;9;19;15;60
"TCCACC";18;12;17;-4;17;60
"TCCAGA";20;13;8;-1;20;60
"TCCGCC";14;8;13;2;23;60
"TCCGGA";16;9;4;5;26;60
"TCCTAA";18;13;8;1;20;60
"TTCAAC";9;16;27;0;8;60
"TTCATA";17;13;14;-1;17;60
"TTCGAC";5;12;23;6;14;60
"TTCGTA";13;9;10;5;23;60
"AACACA";16;21;4;4;16;61
"AACGCA";12;17;0;10;22;61
"ACAAAT";15;17;10;6;13;61
"ACAATC";19;7;16;1;18;61
"ACAGAT";11;13;6;12;19;61
"ACAGTC";15;3;12;7;24;61
"CCAAAA";13;8;10;17;13;61
"CCAGAA";9;4;6;23;19;61
"GACAAG";19;19;3;11;9;61
"GACGAG";15;15;-1;17;15;61
"GCCATT";25;18;0;-5;23;61
"GCCGTT";21;14;-4;1;29;61
"TACATT";16;22;8;1;14;61
"TACGTT";12;18;4;7;20;61
"TCCCAG";24;11;5;6;15;61
"TCCTTG";29;7;1;3;21;61
"AACAGG";21;19;1;10;11;62
"AACGGG";17;15;-3;16;17;62
"AACTAG";19;19;1;12;11;62
"ACCCAT";20;22;2;-1;19;62
"ACCCTC";24;12;8;-6;24;62
"ACCTTT";25;18;-2;-4;25;62
"AGCAAG";20;19;3;10;10;62
"AGCGAG";16;15;-1;16;16;62
"CCAATG";24;2;3;19;14;62
"CCAGTG";20;-2;-1;25;20;62
"CCCACT";19;18;1;7;17;62
"CCCAGC";17;12;11;6;16;62
"CCCCAA";18;13;2;10;19;62
"CCCGCT";15;14;-3;13;23;62
"CCCGGC";13;8;7;12;22;62
"CCCTAC";15;12;11;8;16;62
"CCCTTA";23;9;-2;7;25;62
"CTCAAT";10;22;11;11;8;62
"CTCATC";14;12;17;6;13;62
"CTCGAT";6;18;7;17;14;62
"CTCGTC";10;8;13;12;19;62
"TCCACA";21;13;8;-1;21;62
"TCCGCA";17;9;4;5;27;62
"TTCAAA";12;17;18;3;12;62
"TTCGAA";8;13;14;9;18;62
"ACAAAC";14;11;20;5;13;63
"ACAATA";22;8;7;4;22;63
"ACAGAC";10;7;16;11;19;63
"ACAGTA";18;4;3;10;28;63
"CCCCTG";29;7;-5;12;20;63
"GCCAAT";20;22;4;-1;18;63
"GCCATC";24;12;10;-6;23;63
"GCCGAT";16;18;0;5;24;63
"GCCGTC";20;8;6;0;29;63
"TACAAT";11;26;12;5;9;63
"TACATC";15;16;18;0;14;63
"TACGAT";7;22;8;11;15;63
"TACGTC";11;12;14;6;20;63
"TCCAGG";26;11;5;5;16;63
"TCCGGG";22;7;1;11;22;63
"TCCTAG";24;11;5;7;16;63
"TTCATG";23;11;11;5;13;63
"TTCGTG";19;7;7;11;19;63
"AACACG";22;19;1;10;12;64
"AACGCG";18;15;-3;16;18;64
"ACCAGT";22;22;2;-2;20;64
"ACCCAC";19;16;12;-2;19;64
"ACCCTA";27;13;-1;-3;28;64
"ACCGGT";18;18;-2;4;26;64
"ACCTAT";20;22;2;0;20;64
"ACCTTC";24;12;8;-5;25;64
"ATCATT";19;22;8;-2;17;64
"ATCGTT";15;18;4;4;23;64
"CCAAAG";19;6;7;23;9;64
"CCAGAG";15;2;3;29;15;64
"CCCACC";18;12;11;6;17;64
"CCCAGA";20;13;2;9;20;64
"CCCGCC";14;8;7;12;23;64
"CCCGGA";16;9;-2;15;26;64
"CCCTAA";18;13;2;11;20;64
"CTCAAC";9;16;21;10;8;64
"CTCATA";17;13;8;9;17;64
"CTCGAC";5;12;17;16;14;64
"CTCGTA";13;9;4;15;23;64
"ACAAAA";17;12;11;8;17;65
"ACAGAA";13;8;7;14;23;65
"CACATT";16;22;2;11;14;65
"CACGTT";12;18;-2;17;20;65
"CCCCAG";24;11;-1;16;15;65
"CCCTTG";29;7;-5;13;21;65
"GCCAAC";19;16;14;-2;18;65
"GCCATA";27;13;1;-3;27;65
"GCCGAC";15;12;10;4;24;65
"GCCGTA";23;9;-3;3;33;65
"TACAAC";10;20;22;4;9;65
"TACATA";18;17;9;3;18;65
"TACGAC";6;16;18;10;15;65
"TACGTA";14;13;5;9;24;65
"TCCACG";27;11;5;5;17;65
"TCCGCG";23;7;1;11;23;65
"TTCAAG";18;15;15;9;8;65
"TTCGAG";14;11;11;15;14;65
"ACAATG";28;6;4;10;18;66
"ACAGTG";24;2;0;16;24;66
"ACCACT";23;22;2;-2;21;66
"ACCAGC";21;16;12;-3;20;66
"ACCCAA";22;17;3;1;23;66
"ACCGCT";19;18;-2;4;27;66
"ACCGGC";17;12;8;3;26;66
"ACCTAC";19;16;12;-1;20;66
"ACCTTA";27;13;-1;-2;29;66
"ATCAAT";14;26;12;2;12;66
"ATCATC";18;16;18;-3;17;66
"ATCGAT";10;22;8;8;18;66
"ATCGTC";14;12;14;3;23;66
"CCCACA";21;13;2;9;21;66
"CCCGCA";17;9;-2;15;27;66
"CTCAAA";12;17;12;13;12;66
"CTCGAA";8;13;8;19;18;66
"ACCCTG";33;11;-4;3;24;67
"CACAAT";11;26;6;15;9;67
"CACATC";15;16;12;10;14;67
"CACGAT";7;22;2;21;15;67
"CACGTC";11;12;8;16;20;67
"CCCAGG";26;11;-1;15;16;67
"CCCGGG";22;7;-5;21;22;67
"CCCTAG";24;11;-1;17;16;67
"CTCATG";23;11;5;15;13;67
"CTCGTG";19;7;1;21;19;67
"GCCAAA";22;17;5;1;22;67
"GCCGAA";18;13;1;7;28;67
"TACAAA";13;21;13;7;13;67
"TACGAA";9;17;9;13;19;67
"ACAAAG";23;10;8;14;13;68
"ACAGAG";19;6;4;20;19;68
"ACCACC";22;16;12;-3;21;68
"ACCAGA";24;17;3;0;24;68
"ACCGCC";18;12;8;3;27;68
"ACCGGA";20;13;-1;6;30;68
"ACCTAA";22;17;3;2;24;68
"ATCAAC";13;20;22;1;12;68
"ATCATA";21;17;9;0;21;68
"ATCGAC";9;16;18;7;18;68
"ATCGTA";17;13;5;6;27;68
"GCCATG";33;11;-2;3;23;68
"GCCGTG";29;7;-6;9;29;68
"TACATG";24;15;6;9;14;68
"TACGTG";20;11;2;15;20;68
"AACATT";20;26;3;2;18;69
"AACGTT";16;22;-1;8;24;69
"ACCCAG";28;15;0;7;19;69
"ACCTTG";33;11;-4;4;25;69
"CACAAC";10;20;16;14;9;69
"CACATA";18;17;3;13;18;69
"CACGAC";6;16;12;20;15;69
"CACGTA";14;13;-1;19;24;69
"CCCACG";27;11;-1;15;17;69
"CCCGCG";23;7;-5;21;23;69
"CTCAAG";18;15;9;19;8;69
"CTCGAG";14;11;5;25;14;69
"ACCACA";25;17;3;0;25;70
"ACCGCA";21;13;-1;6;31;70
"ATCAAA";16;21;13;4;16;70
"ATCGAA";12;17;9;10;22;70
"GCCAAG";28;15;2;7;18;70
"GCCGAG";24;11;-2;13;24;70
"TACAAG";19;19;10;13;9;70
"TACGAG";15;15;6;19;15;70
"TCCATT";25;18;7;-3;23;70
"TCCGTT";21;14;3;3;29;70
"AACAAT";15;30;7;6;13;71
"AACATC";19;20;13;1;18;71
"AACGAT";11;26;3;12;19;71
"AACGTC";15;16;9;7;24;71
"ACCAGG";30;15;0;6;20;71
"ACCGGG";26;11;-4;12;26;71
"ACCTAG";28;15;0;8;20;71
"ATCATG";27;15;6;6;17;71
"ATCGTG";23;11;2;12;23;71
"CACAAA";13;21;7;17;13;71
"CACGAA";9;17;3;23;19;71
"CACATG";24;15;0;19;14;72
"CACGTG";20;11;-4;25;20;72
"TCCAAT";20;22;11;1;18;72
"TCCATC";24;12;17;-4;23;72
"TCCGAT";16;18;7;7;24;72
"TCCGTC";20;8;13;2;29;72
"AACAAC";14;24;17;5;13;73
"AACATA";22;21;4;4;22;73
"AACGAC";10;20;13;11;19;73
"AACGTA";18;17;0;10;28;73
"ACCACG";31;15;0;6;21;73
"ACCGCG";27;11;-4;12;27;73
"ATCAAG";22;19;10;10;12;73
"ATCGAG";18;15;6;16;18;73
"CACAAG";19;19;4;23;9;74
"CACGAG";15;15;0;29;15;74
"CCCATT";25;18;1;7;23;74
"CCCGTT";21;14;-3;13;29;74
"TCCAAC";19;16;21;0;18;74
"TCCATA";27;13;8;-1;27;74
"TCCGAC";15;12;17;6;24;74
"TCCGTA";23;9;4;5;33;74
"AACAAA";17;25;8;8;17;75
"AACGAA";13;21;4;14;23;75
"AACATG";28;19;1;10;18;76
"AACGTG";24;15;-3;16;24;76
"CCCAAT";20;22;5;11;18;76
"CCCATC";24;12;11;6;23;76
"CCCGAT";16;18;1;17;24;76
"CCCGTC";20;8;7;12;29;76
"TCCAAA";22;17;12;3;22;76
"TCCGAA";18;13;8;9;28;76
"TCCATG";33;11;5;5;23;77
"TCCGTG";29;7;1;11;29;77
"AACAAG";23;23;5;14;13;78
"AACGAG";19;19;1;20;19;78
"ACCATT";29;22;2;-2;27;78
"ACCGTT";25;18;-2;4;33;78
"CCCAAC";19;16;15;10;18;78
"CCCATA";27;13;2;9;27;78
"CCCGAC";15;12;11;16;24;78
"CCCGTA";23;9;-2;15;33;78
"TCCAAG";28;15;9;9;18;79
"TCCGAG";24;11;5;15;24;79
"ACCAAT";24;26;6;2;22;80
"ACCATC";28;16;12;-3;27;80
"ACCGAT";20;22;2;8;28;80
"ACCGTC";24;12;8;3;33;80
"CCCAAA";22;17;6;13;22;80
"CCCGAA";18;13;2;19;28;80
"CCCATG";33;11;-1;15;23;81
"CCCGTG";29;7;-5;21;29;81
"ACCAAC";23;20;16;1;22;82
"ACCATA";31;17;3;0;31;82
"ACCGAC";19;16;12;7;28;82
"ACCGTA";27;13;-1;6;37;82
"CCCAAG";28;15;3;19;18;83
"CCCGAG";24;11;-1;25;24;83
"ACCAAA";26;21;7;4;26;84
"ACCGAA";22;17;3;10;32;84
"ACCATG";37;15;0;6;27;85
"ACCGTG";33;11;-4;12;33;85
"ACCAAG";32;19;4;10;22;87
"ACCGAG";28;15;0;16;28;87
