"";"TGGTAC";"TTGTTA";"AATTTG";"GTTCTC";"TGGCAT";"score.global"
"CCCGGG";-12;-9;1;-13;-12;-45
"CCCGCG";-12;-8;2;-12;-12;-42
"CCCGGT";-10;-9;-7;-11;-5;-42
"CCCGCT";-10;-8;-6;-10;-5;-39
"CCCGGA";-9;-5;-5;-10;-10;-39
"GCCGGG";-13;-10;1;-4;-13;-39
"CCCGCA";-9;-4;-4;-9;-10;-36
"GCCGCG";-13;-9;2;-3;-13;-36
"GCCGGT";-11;-10;-7;-2;-6;-36
"ACCGGG";-11;-8;5;-10;-11;-35
"CCAGGG";-9;-6;2;-12;-9;-34
"CACGGG";-9;-8;5;-12;-9;-33
"CCCAGG";-10;-7;3;-10;-9;-33
"GCCGCT";-11;-9;-6;-1;-6;-33
"GCCGGA";-10;-6;-5;-1;-11;-33
"ACCGCG";-11;-7;6;-9;-11;-32
"ACCGGT";-9;-8;-3;-8;-4;-32
"CCAGCG";-9;-5;3;-11;-9;-31
"CCAGGT";-7;-6;-6;-10;-2;-31
"CCCGAG";-8;-7;3;-11;-8;-31
"CTCGGG";-11;-3;1;-7;-11;-31
"CACGCG";-9;-7;6;-11;-9;-30
"CACGGT";-7;-8;-3;-10;-2;-30
"CCCACG";-10;-6;4;-9;-9;-30
"CCCAGT";-8;-7;-5;-8;-2;-30
"CCTGGG";-11;-8;7;-7;-11;-30
"GCCGCA";-10;-5;-4;0;-11;-30
"ACCGCT";-9;-7;-2;-7;-4;-29
"ACCGGA";-8;-4;-1;-7;-9;-29
"CCCGGC";0;-9;-8;-1;-11;-29
"CGCGGG";-3;-10;1;-14;-3;-29
"CCAGCT";-7;-5;-5;-9;-2;-28
"CCAGGA";-6;-2;-4;-9;-7;-28
"CCCGAT";-6;-7;-5;-9;-1;-28
"CTCGCG";-11;-2;2;-6;-11;-28
"CTCGGT";-9;-3;-7;-5;-4;-28
"GCAGGG";-10;-7;2;-3;-10;-28
"CACGCT";-7;-7;-2;-9;-2;-27
"CACGGA";-6;-4;-1;-9;-7;-27
"CCCACT";-8;-6;-4;-7;-2;-27
"CCCAGA";-7;-3;-3;-7;-7;-27
"CCTGCG";-11;-7;8;-6;-11;-27
"CCTGGT";-9;-8;-1;-5;-4;-27
"GACGGG";-10;-9;5;-3;-10;-27
"GCCAGG";-11;-8;3;-1;-10;-27
"ACCGCA";-8;-3;0;-6;-9;-26
"CCCGCC";0;-8;-7;0;-11;-26
"CGCGCG";-3;-9;2;-13;-3;-26
"CGCGGT";-1;-10;-7;-12;4;-26
"TCCGGG";-6;-3;1;-12;-6;-26
"CCAGCA";-6;-1;-3;-8;-7;-25
"CCCGAA";-5;-3;-3;-8;-6;-25
"CTCGCT";-9;-2;-6;-4;-4;-25
"CTCGGA";-8;1;-5;-4;-9;-25
"GCAGCG";-10;-6;3;-2;-10;-25
"GCAGGT";-8;-7;-6;-1;-3;-25
"GCCGAG";-9;-8;3;-2;-9;-25
"GTCGGG";-12;-4;1;2;-12;-25
"ACAGGG";-8;-5;6;-9;-8;-24
"CACGCA";-6;-3;0;-8;-7;-24
"CCCACA";-7;-2;-2;-6;-7;-24
"CCCGTG";-12;-2;8;-6;-12;-24
"CCTGCT";-9;-7;0;-4;-4;-24
"CCTGGA";-8;-4;1;-4;-9;-24
"GACGCG";-10;-8;6;-2;-10;-24
"GACGGT";-8;-9;-3;-1;-3;-24
"GCCACG";-11;-7;4;0;-10;-24
"GCCAGT";-9;-8;-5;1;-3;-24
"GCTGGG";-12;-9;7;2;-12;-24
"AACGGG";-8;-7;9;-9;-8;-23
"ACCAGG";-9;-6;7;-7;-8;-23
"CGCGCT";-1;-9;-6;-11;4;-23
"CGCGGA";0;-6;-5;-11;-1;-23
"GCCGGC";-1;-10;-8;8;-12;-23
"GGCGGG";-4;-11;1;-5;-4;-23
"TCCGGT";-4;-3;-7;-10;1;-23
"CAAGGG";-6;-5;6;-11;-6;-22
"CCAAGG";-7;-4;4;-9;-6;-22
"GCAGCT";-8;-6;-5;0;-3;-22
"GCAGGA";-7;-3;-4;0;-8;-22
"GCCGAT";-7;-8;-5;0;-2;-22
"GTCGGT";-10;-4;-7;4;-5;-22
"ACAGCG";-8;-4;7;-8;-8;-21
"ACAGGT";-6;-5;-2;-7;-1;-21
"ACCGAG";-7;-6;7;-8;-7;-21
"ATCGGG";-10;-2;5;-4;-10;-21
"CACAGG";-7;-6;7;-9;-6;-21
"CCCGTT";-10;-2;0;-4;-5;-21
"CCTGCA";-8;-3;2;-3;-9;-21
"GACGCT";-8;-8;-2;0;-3;-21
"GACGGA";-7;-5;-1;0;-8;-21
"GCCACT";-9;-7;-4;2;-3;-21
"GCCAGA";-8;-4;-3;2;-8;-21
"GCTGGT";-10;-9;-1;4;-5;-21
"GTCGCG";-12;-3;2;3;-11;-21
"AACGCG";-8;-6;10;-8;-8;-20
"AACGGT";-6;-7;1;-7;-1;-20
"ACCACG";-9;-5;8;-6;-8;-20
"ACCAGT";-7;-6;-1;-5;-1;-20
"ACTGGG";-10;-7;11;-4;-10;-20
"CCAGAG";-5;-4;4;-10;-5;-20
"CCCTGG";-5;-2;8;-11;-10;-20
"CCGGGG";-3;0;0;-14;-3;-20
"CGCGCA";0;-5;-4;-10;-1;-20
"CTAGGG";-8;0;2;-6;-8;-20
"CTCGCA";-8;2;-4;-3;-7;-20
"GCCGCC";-1;-9;-7;9;-12;-20
"GCTGCG";-11;-8;8;3;-12;-20
"GGCGCG";-4;-10;2;-4;-4;-20
"GGCGGT";-2;-11;-7;-3;3;-20
"TCCGCG";-6;-2;2;-8;-6;-20
"TCCGGA";-3;1;-5;-9;-4;-20
"ACCGGC";1;-8;-4;2;-10;-19
"AGCGGG";-2;-9;5;-11;-2;-19
"CAAGCG";-6;-4;7;-10;-6;-19
"CAAGGT";-4;-5;-2;-9;1;-19
"CACGAG";-5;-6;7;-10;-5;-19
"CCAACG";-7;-3;5;-8;-6;-19
"CCAAGT";-5;-4;-4;-7;1;-19
"CCCAAG";-6;-5;5;-8;-5;-19
"CTCAGG";-9;-1;3;-4;-8;-19
"GCAGCA";-7;-2;-3;1;-8;-19
"GCCGAA";-6;-4;-3;1;-7;-19
"GTCGCT";-10;-3;-6;5;-5;-19
"GTCGGA";-9;0;-5;5;-10;-19
"TCCGCT";-4;-2;-6;-8;1;-19
"ACAGCT";-6;-4;-1;-6;-1;-18
"ACAGGA";-5;-1;0;-6;-6;-18
"ACCGAT";-5;-6;-1;-6;0;-18
"ATCGCG";-10;-1;6;-3;-10;-18
"ATCGGT";-8;-2;-3;-2;-3;-18
"CACACG";-7;-5;8;-8;-6;-18
"CACAGT";-5;-6;-1;-7;1;-18
"CATGGG";-8;-7;11;-6;-8;-18
"CCAGGC";3;-6;-7;0;-8;-18
"CCCCGG";-11;-8;2;-1;0;-18
"CCCGTA";-9;2;2;-3;-10;-18
"CCTAGG";-9;-6;9;-4;-8;-18
"CGAGGG";0;-7;2;-13;0;-18
"GACGCA";-7;-4;0;1;-8;-18
"GCCACA";-8;-3;-2;3;-8;-18
"GCTGCT";-10;-8;0;5;-5;-18
"GCTGGA";-9;-5;1;5;-10;-18
"AACGCT";-6;-6;2;-6;-1;-17
"AACGGA";-5;-3;3;-6;-6;-17
"ACCACT";-7;-5;0;-4;-1;-17
"ACCAGA";-6;-2;1;-4;-6;-17
"ACTGCG";-10;-6;12;-3;-10;-17
"ACTGGT";-8;-7;3;-2;-3;-17
"CACGGC";3;-8;-4;0;-8;-17
"CCAGAT";-3;-4;-4;-8;2;-17
"CCCAGC";2;-7;-6;2;-8;-17
"CCCTGT";-3;-2;0;-9;-3;-17
"CCGGCG";-3;1;1;-13;-3;-17
"CCGGGT";-1;0;-8;-12;4;-17
"CGCAGG";-1;-8;3;-11;0;-17
"CTAGCG";-8;1;3;-5;-8;-17
"CTAGGT";-6;0;-6;-4;-1;-17
"CTCGAG";-7;-1;3;-5;-7;-17
"GGCGCT";-2;-10;-6;-2;3;-17
"GGCGGA";-1;-7;-5;-2;-2;-17
"TCCGCA";-3;2;-4;-8;-4;-17
"ACCGCC";1;-7;-3;3;-10;-16
"AGCGCG";-2;-8;6;-10;-2;-16
"AGCGGT";0;-9;-3;-9;5;-16
"CAAGCT";-4;-4;-1;-8;1;-16
"CAAGGA";-3;-1;0;-8;-4;-16
"CACGAT";-3;-6;-1;-8;2;-16
"CCAACT";-5;-3;-3;-6;1;-16
"CCAAGA";-4;0;-2;-6;-4;-16
"CCCAAT";-4;-5;-3;-6;2;-16
"CCTGAG";-7;-6;9;-5;-7;-16
"CTCACG";-9;0;4;-3;-8;-16
"CTCAGT";-7;-1;-5;-2;-1;-16
"CTTGGG";-10;-2;7;-1;-10;-16
"GAAGGG";-7;-6;6;-2;-7;-16
"GCAAGG";-8;-5;4;0;-7;-16
"GCCGTG";-13;-3;8;3;-11;-16
"ACAGCA";-5;0;1;-5;-6;-15
"ACCGAA";-4;-2;1;-5;-5;-15
"ATCGCT";-8;-1;-2;-1;-3;-15
"ATCGGA";-7;2;-1;-1;-8;-15
"CACACT";-5;-5;0;-6;1;-15
"CACAGA";-4;-2;1;-6;-4;-15
"CATGCG";-8;-6;12;-5;-8;-15
"CATGGT";-6;-7;3;-4;-1;-15
"CCAGCC";3;-5;-6;1;-8;-15
"CCCCCG";-11;-7;3;0;0;-15
"CCCCGT";-9;-8;-6;1;7;-15
"CCCGAC";4;-7;-6;1;-7;-15
"CCTACG";-9;-5;10;-3;-8;-15
"CCTAGT";-7;-6;1;-2;-1;-15
"CGAGCG";0;-6;3;-12;0;-15
"CGAGGT";2;-7;-6;-11;7;-15
"CGCGAG";1;-8;3;-12;1;-15
"CTCGGC";1;-3;-8;5;-10;-15
"GACAGG";-8;-7;7;0;-7;-15
"GCCGTT";-11;-3;0;5;-6;-15
"GCTGCA";-9;-4;2;6;-10;-15
"TCAGGG";-3;0;2;-11;-3;-15
"AACGCA";-5;-2;4;-5;-6;-14
"ACCACA";-6;-1;2;-3;-6;-14
"ACCGTG";-11;-1;12;-3;-11;-14
"ACTGCT";-8;-6;4;-1;-3;-14
"ACTGGA";-7;-3;5;-1;-8;-14
"CACGCC";3;-7;-3;1;-8;-14
"CCAGAA";-2;0;-2;-7;-3;-14
"CCCACC";2;-6;-5;3;-8;-14
"CCCTCG";-5;-1;9;-7;-10;-14
"CCCTGA";-2;2;2;-8;-8;-14
"CCGGCT";-1;1;-7;-11;4;-14
"CCGGGA";0;4;-6;-11;-1;-14
"CCTGGC";1;-8;-2;5;-10;-14
"CGCACG";-1;-7;4;-10;0;-14
"CGCAGT";1;-8;-5;-9;7;-14
"CGTGGG";-2;-9;7;-8;-2;-14
"CTAGCT";-6;1;-5;-3;-1;-14
"CTAGGA";-5;4;-4;-3;-6;-14
"CTCGAT";-5;-1;-5;-3;0;-14
"GCAGAG";-6;-5;4;-1;-6;-14
"GCCTGG";-6;-3;8;-2;-11;-14
"GCGGGG";-4;-1;0;-5;-4;-14
"GGCGCA";-1;-6;-4;-1;-2;-14
"GTAGGG";-9;-1;2;3;-9;-14
"TACGGG";-3;-2;5;-11;-3;-14
"TCCAGG";-4;-1;3;-9;-3;-14
"AGCGCT";0;-8;-2;-8;5;-13
"AGCGGA";1;-5;-1;-8;0;-13
"CAAGCA";-3;0;1;-7;-4;-13
"CACGAA";-2;-2;1;-7;-3;-13
"CCAACA";-4;1;-1;-5;-4;-13
"CCAGTG";-9;1;9;-5;-9;-13
"CCCAAA";-3;-1;-1;-5;-3;-13
"CCCTCT";-3;-1;1;-7;-3;-13
"CCTGAT";-5;-6;1;-3;0;-13
"CGCGGC";9;-10;-8;-2;-2;-13
"CTCACT";-7;0;-4;-1;-1;-13
"CTCAGA";-6;3;-3;-1;-6;-13
"CTTGCG";-10;-1;8;0;-10;-13
"CTTGGT";-8;-2;-1;1;-3;-13
"GAAGCG";-7;-5;7;-1;-7;-13
"GAAGGT";-5;-6;-2;0;0;-13
"GACGAG";-6;-7;7;-1;-6;-13
"GCAACG";-8;-4;5;1;-7;-13
"GCAAGT";-6;-5;-4;2;0;-13
"GCCAAG";-7;-6;5;1;-6;-13
"GTCAGG";-10;-2;3;5;-9;-13
"GTCGCA";-9;1;-4;6;-7;-13
"AAAGGG";-5;-4;10;-8;-5;-12
"ACAAGG";-6;-3;8;-6;-5;-12
"CACACA";-4;-1;2;-5;-4;-12
"CACGTG";-9;-1;12;-5;-9;-12
"CATGCT";-6;-6;4;-3;-1;-12
"CATGGA";-5;-3;5;-3;-6;-12
"CCCATG";-10;0;10;-3;-9;-12
"CCCCCT";-9;-7;-5;2;7;-12
"CCCCGA";-8;-4;-4;2;2;-12
"CCTACT";-7;-5;2;-1;-1;-12
"CCTAGA";-6;-2;3;-1;-6;-12
"CGAGCT";2;-6;-5;-10;7;-12
"CGAGGA";3;-3;-4;-10;2;-12
"CGCGAT";3;-8;-5;-10;8;-12
"CTCGCC";1;-2;-7;6;-10;-12
"GACACG";-8;-6;8;1;-7;-12
"GACAGT";-6;-7;-1;2;0;-12
"GATGGG";-9;-8;11;3;-9;-12
"GCAGGC";2;-7;-7;9;-9;-12
"GCCCGG";-12;-9;2;8;-1;-12
"GCCGTA";-10;1;2;6;-11;-12
"GCTAGG";-10;-7;9;5;-9;-12
"GGAGGG";-1;-8;2;-4;-1;-12
"TCAGCG";-3;1;3;-10;-3;-12
"TCAGGT";-1;0;-6;-9;4;-12
"TCCGAG";-2;-1;3;-10;-2;-12
"TTCGGG";-5;3;1;-6;-5;-12
"AACAGG";-6;-5;11;-6;-5;-11
"ACCGTT";-9;-1;4;-1;-4;-11
"ACTGCA";-7;-2;6;0;-8;-11
"ATCGCA";-7;3;0;0;-7;-11
"CCCTCA";-2;3;3;-7;-8;-11
"CCGGCA";0;5;-5;-10;-1;-11
"CCTGCC";1;-7;-1;6;-10;-11
"CGCACT";1;-7;-4;-8;7;-11
"CGCAGA";2;-4;-3;-8;2;-11
"CGTGCG";-2;-8;8;-7;-2;-11
"CGTGGT";0;-9;-1;-6;5;-11
"CTCGAA";-4;3;-3;-2;-5;-11
"GACGGC";2;-9;-4;9;-9;-11
"GCAGAT";-4;-5;-4;1;1;-11
"GCCAGC";1;-8;-6;11;-9;-11
"GCCTGT";-4;-3;0;0;-4;-11
"GCGGCG";-4;0;1;-4;-4;-11
"GCGGGT";-2;-1;-8;-3;3;-11
"GGCAGG";-2;-9;3;-2;-1;-11
"GTAGGT";-7;-1;-6;5;-2;-11
"GTCGAG";-8;-2;3;4;-8;-11
"TACGGT";-1;-2;-3;-9;4;-11
"TCCAGT";-2;-1;-5;-7;4;-11
"TCTGGG";-5;-2;7;-6;-5;-11
"ACAGAG";-4;-3;8;-7;-4;-10
"ACCTGG";-4;-1;12;-8;-9;-10
"ACGGGG";-2;1;4;-11;-2;-10
"AGCGCA";1;-4;0;-7;0;-10
"ATAGGG";-7;1;6;-3;-7;-10
"CAAAGG";-4;-3;8;-8;-3;-10
"CCAGTT";-7;1;1;-3;-2;-10
"CCTGAA";-4;-2;3;-2;-5;-10
"CGCGCC";9;-9;-7;-1;-2;-10
"CTCACA";-6;4;-2;0;-6;-10
"CTCGTG";-11;4;8;0;-11;-10
"CTTGCT";-8;-1;0;2;-3;-10
"CTTGGA";-7;2;1;2;-8;-10
"GAAGCT";-5;-5;-1;1;0;-10
"GAAGGA";-4;-2;0;1;-5;-10
"GACGAT";-4;-7;-1;1;1;-10
"GCAACT";-6;-4;-3;3;0;-10
"GCAAGA";-5;-1;-2;3;-5;-10
"GCCAAT";-5;-6;-3;3;1;-10
"GCCTCG";-6;-2;9;0;-11;-10
"GCTGAG";-8;-7;9;4;-8;-10
"GTAGCG";-9;0;3;4;-8;-10
"GTCACG";-10;-1;4;6;-9;-10
"GTCAGT";-8;-2;-5;7;-2;-10
"GTTGGG";-11;-3;7;8;-11;-10
"TCCGGC";6;-3;-8;0;-5;-10
"TGCGGG";3;-4;1;-13;3;-10
"AAAGCG";-5;-3;11;-7;-5;-9
"AAAGGT";-3;-4;2;-6;2;-9
"AACGAG";-4;-5;11;-7;-4;-9
"ACAACG";-6;-2;9;-5;-5;-9
"ACAAGT";-4;-3;0;-4;2;-9
"ACCAAG";-5;-4;9;-5;-4;-9
"ATCAGG";-8;0;7;-1;-7;-9
"CACGTT";-7;-1;4;-3;-2;-9
"CATGCA";-5;-2;6;-2;-6;-9
"CCATGG";-2;1;9;-10;-7;-9
"CCCATT";-8;0;2;-1;-2;-9
"CCCCCA";-8;-3;-3;3;2;-9
"CCTACA";-6;-1;4;0;-6;-9
"CCTGTG";-11;-1;14;0;-11;-9
"CGAGCA";3;-2;-3;-9;2;-9
"CGCGAA";4;-4;-3;-9;3;-9
"CTAGCA";-5;5;-3;-2;-4;-9
"GACACT";-6;-6;0;3;0;-9
"GACAGA";-5;-3;1;3;-5;-9
"GATGGT";-7;-8;3;5;-2;-9
"GCAGCC";2;-6;-6;10;-9;-9
"GCCCCG";-12;-8;3;9;-1;-9
"GCCCGT";-10;-9;-6;10;6;-9
"GCCGAC";3;-8;-6;10;-8;-9
"GCTAGT";-8;-7;1;7;-2;-9
"GGAGCG";-1;-7;3;-3;-1;-9
"GGAGGT";1;-8;-6;-2;6;-9
"GGCGAG";0;-9;3;-3;0;-9
"GTCGGC";0;-4;-8;14;-11;-9
"TCAGCT";-1;1;-5;-8;4;-9
"TCAGGA";0;4;-4;-8;-1;-9
"TCCACG";-4;0;4;-6;-3;-9
"TCCGAT";0;-1;-5;-8;5;-9
"TTCGGT";-3;3;-7;-4;2;-9
"AACACG";-6;-4;12;-5;-5;-8
"AACAGT";-4;-5;3;-4;2;-8
"AATGGG";-7;-6;15;-3;-7;-8
"ACAGGC";4;-5;-3;3;-7;-8
"ACCCGG";-10;-7;6;2;1;-8
"ACCGTA";-8;3;6;0;-9;-8
"ACTAGG";-8;-5;13;-1;-7;-8
"AGAGGG";1;-6;6;-10;1;-8
"CAAGAG";-2;-3;8;-9;-2;-8
"CACTGG";-2;-1;12;-10;-7;-8
"CAGGGG";0;1;4;-13;0;-8
"CCAAAG";-3;-2;6;-7;-2;-8
"CCCGTC";0;-2;-1;6;-11;-8
"CCGAGG";-1;2;2;-11;0;-8
"CGCACA";2;-3;-2;-7;2;-8
"CGCGTG";-3;-3;8;-7;-3;-8
"CGTGCT";0;-8;0;-5;5;-8
"CGTGGA";1;-5;1;-5;0;-8
"CTAAGG";-6;2;4;-3;-5;-8
"GACGCC";2;-8;-3;10;-9;-8
"GATGCG";-8;-7;12;4;-9;-8
"GCAGAA";-3;-1;-2;2;-4;-8
"GCCACC";1;-7;-5;12;-9;-8
"GCCTCT";-4;-2;1;1;-4;-8
"GCCTGA";-3;1;2;1;-9;-8
"GCGGCT";-2;0;-7;-2;3;-8
"GCGGGA";-1;3;-6;-2;-2;-8
"GGCACG";-2;-8;4;-1;-1;-8
"GGCAGT";0;-9;-5;0;6;-8
"GGTGGG";-3;-10;7;1;-3;-8
"GTAGCT";-7;0;-5;6;-2;-8
"GTAGGA";-6;3;-4;6;-7;-8
"GTCGAT";-6;-2;-5;6;-1;-8
"TACGCG";-3;-1;6;-7;-3;-8
"TACGGA";0;2;-1;-8;-1;-8
"TCCACT";-2;0;-4;-6;4;-8
"TCCAGA";-1;3;-3;-6;-1;-8
"TCTGCG";-5;-1;8;-5;-5;-8
"TCTGGT";-3;-2;-1;-4;2;-8
"AACGGC";4;-7;0;3;-7;-7
"ACAGAT";-2;-3;0;-5;3;-7
"ACCAGC";3;-6;-2;5;-7;-7
"ACCTGT";-2;-1;4;-6;-2;-7
"ACGGCG";-2;2;5;-10;-2;-7
"ACGGGT";0;1;-4;-9;5;-7
"AGCAGG";0;-7;7;-8;1;-7
"ATAGCG";-7;2;7;-2;-7;-7
"ATAGGT";-5;1;-2;-1;0;-7
"ATCGAG";-6;0;7;-2;-6;-7
"CAAACG";-4;-2;9;-7;-3;-7
"CAAAGT";-2;-3;0;-6;4;-7
"CACAAG";-3;-4;9;-7;-2;-7
"CCACGG";-8;-5;3;0;3;-7
"CCAGTA";-6;5;3;-2;-7;-7
"CTCGTT";-9;4;0;2;-4;-7
"GAAGCA";-4;-1;1;2;-5;-7
"GACGAA";-3;-3;1;2;-4;-7
"GCAACA";-5;0;-1;4;-5;-7
"GCAGTG";-10;0;9;4;-10;-7
"GCCAAA";-4;-2;-1;4;-4;-7
"GCTGAT";-6;-7;1;6;-1;-7
"GCTGGC";0;-9;-2;14;-10;-7
"GGCGGC";8;-11;-8;7;-3;-7
"GTCACT";-8;-1;-4;8;-2;-7
"GTCAGA";-7;2;-3;8;-7;-7
"GTTGGT";-9;-3;-1;10;-4;-7
"TACGCT";-1;-1;-2;-7;4;-7
"TCCGCC";6;-2;-7;1;-5;-7
"TGCGGT";5;-4;-7;-11;10;-7
"AAAGCT";-3;-3;3;-5;2;-6
"AAAGGA";-2;0;4;-5;-3;-6
"AACGAT";-2;-5;3;-5;3;-6
"ACAACT";-4;-2;1;-3;2;-6
"ACAAGA";-3;1;2;-3;-3;-6
"ACCAAT";-3;-4;1;-3;3;-6
"ACCTCG";-4;0;13;-6;-9;-6
"ACTGAG";-6;-5;13;-2;-6;-6
"ATCACG";-8;1;8;0;-7;-6
"ATCAGT";-6;0;-1;1;0;-6
"ATTGGG";-9;-1;11;2;-9;-6
"CAAGGC";6;-5;-3;1;-5;-6
"CACCGG";-8;-7;6;0;3;-6
"CACGTA";-6;3;6;-2;-7;-6
"CATAGG";-6;-5;13;-3;-5;-6
"CCAAGC";5;-4;-5;3;-5;-6
"CCATCG";-2;2;10;-9;-7;-6
"CCATGT";0;1;1;-8;0;-6
"CCCATA";-7;4;4;0;-7;-6
"CCCTAG";-1;0;10;-9;-6;-6
"CCGGAG";1;2;2;-12;1;-6
"CCTGTT";-9;-1;6;2;-4;-6
"CGAAGG";2;-5;4;-10;3;-6
"CTAGAG";-4;2;4;-4;-4;-6
"CTCTGG";-4;4;8;-5;-9;-6
"CTGGGG";-2;6;0;-8;-2;-6
"GACACA";-5;-2;2;4;-5;-6
"GATGCT";-7;-7;4;6;-2;-6
"GATGGA";-6;-4;5;6;-7;-6
"GCCCCT";-10;-8;-5;11;6;-6
"GCCCGA";-9;-5;-4;11;1;-6
"GCTACG";-7;-6;10;6;-9;-6
"GCTAGA";-7;-3;3;8;-7;-6
"GGAGCT";1;-7;-5;-1;6;-6
"GGAGGA";2;-4;-4;-1;1;-6
"GGCGAT";2;-9;-5;-1;7;-6
"GTCGCC";0;-3;-7;15;-11;-6
"TCAGCA";0;5;-3;-7;-1;-6
"TCCGAA";1;3;-3;-7;0;-6
"TTCGCG";-5;4;2;-2;-5;-6
"TTCGGA";-2;7;-5;-3;-3;-6
"AACACT";-4;-4;4;-3;2;-5
"AACAGA";-3;-1;5;-3;-3;-5
"AATGCG";-7;-5;16;-2;-7;-5
"AATGGT";-5;-6;7;-1;0;-5
"ACAGCC";4;-4;-2;4;-7;-5
"ACCCCG";-10;-6;7;3;1;-5
"ACCCGT";-8;-7;-2;4;8;-5
"ACCGAC";5;-6;-2;4;-6;-5
"ACTACG";-8;-4;14;0;-7;-5
"ACTAGT";-6;-5;5;1;0;-5
"AGAGCG";1;-5;7;-9;1;-5
"AGAGGT";3;-6;-2;-8;8;-5
"AGCGAG";2;-7;7;-9;2;-5
"ATCGGC";2;-2;-4;8;-9;-5
"CAAGAT";0;-3;0;-7;5;-5
"CACAGC";5;-6;-2;3;-5;-5
"CACTGT";0;-1;4;-8;0;-5
"CAGGCG";0;2;5;-12;0;-5
"CAGGGT";2;1;-4;-11;7;-5
"CCAAAT";-1;-2;-2;-5;5;-5
"CCGACG";-1;3;3;-10;0;-5
"CCGAGT";1;2;-6;-9;7;-5
"CCTTGG";-4;-1;14;-5;-9;-5
"CGCGTT";-1;-3;0;-5;4;-5
"CGTGCA";1;-4;2;-4;0;-5
"CTAACG";-6;3;5;-2;-5;-5
"CTAAGT";-4;2;-4;-1;2;-5
"CTCAAG";-5;1;5;-2;-4;-5
"CTTGCA";-7;3;2;3;-6;-5
"GCCTCA";-3;2;3;2;-9;-5
"GCGGCA";-1;4;-5;-1;-2;-5
"GCTACT";-7;-6;2;8;-2;-5
"GCTGCC";0;-8;-1;15;-11;-5
"GGCACT";0;-8;-4;1;6;-5
"GGCAGA";1;-5;-3;1;1;-5
"GGTGGT";-1;-10;-1;3;4;-5
"GTCGAA";-5;2;-3;7;-6;-5
"GTTGCG";-10;-2;8;9;-10;-5
"TACGCA";0;3;0;-7;-1;-5
"TCCACA";-1;4;-2;-5;-1;-5
"TCCGTG";-6;4;8;-5;-6;-5
"TCTGCT";-3;-1;0;-3;2;-5
"TCTGGA";-2;2;1;-3;-3;-5
"TTCGCT";-3;4;-6;-2;2;-5
"AACGCC";4;-6;1;4;-7;-4
"ACAGAA";-1;1;2;-4;-2;-4
"ACCACC";3;-5;-1;6;-7;-4
"ACCTCT";-2;0;5;-5;-2;-4
"ACCTGA";-1;3;6;-5;-7;-4
"ACGGCT";0;2;-3;-8;5;-4
"ACGGGA";1;5;-2;-8;0;-4
"ACTGGC";2;-7;2;8;-9;-4
"AGCACG";0;-6;8;-7;1;-4
"AGCAGT";2;-7;-1;-6;8;-4
"AGTGGG";-1;-8;11;-5;-1;-4
"ATAGCT";-5;2;-1;0;0;-4
"ATAGGA";-4;5;0;0;-5;-4
"ATCGAT";-4;0;-1;0;1;-4
"CAAACT";-2;-2;1;-5;4;-4
"CAAAGA";-1;1;2;-5;-1;-4
"CACAAT";-1;-4;1;-5;5;-4
"CATGAG";-4;-5;13;-4;-4;-4
"CCACCG";-8;-4;4;1;3;-4
"CCACGT";-6;-5;-5;2;10;-4
"CCAGAC";7;-4;-5;2;-4;-4
"CCCCAG";-7;-6;4;1;4;-4
"CCCTGC";7;-2;-1;1;-9;-4
"CCGGGC";9;0;-9;-2;-2;-4
"CCTAAG";-5;-4;11;-2;-4;-4
"CGAGAG";4;-5;4;-11;4;-4
"CGCTGG";4;-3;8;-12;-1;-4
"CGGGGG";6;-1;0;-15;6;-4
"CTAGGC";4;0;-7;6;-7;-4
"CTCCGG";-10;-2;2;5;1;-4
"CTCGTA";-8;8;2;3;-9;-4
"CTTAGG";-8;0;9;2;-7;-4
"GAAAGG";-5;-4;8;1;-4;-4
"GACGTG";-10;-2;12;4;-8;-4
"GCAGTT";-8;0;1;6;-3;-4
"GCTGAA";-5;-3;3;7;-6;-4
"GGCGCC";8;-10;-7;8;-3;-4
"GGTGCG";-2;-9;8;2;-3;-4
"GTCACA";-7;3;-2;9;-7;-4
"GTTGCT";-9;-2;0;11;-4;-4
"GTTGGA";-8;1;1;11;-9;-4
"TGCGCG";3;-3;2;-9;3;-4
"TGCGGA";6;0;-5;-10;5;-4
"AAAGCA";-2;1;5;-4;-3;-3
"AACGAA";-1;-1;5;-4;-2;-3
"ACAACA";-3;2;3;-2;-3;-3
"ACAGTG";-8;2;13;-2;-8;-3
"ACCAAA";-2;0;3;-2;-2;-3
"ACTGAT";-4;-5;5;0;1;-3
"AGCGGC";10;-9;-4;1;-1;-3
"ATCACT";-6;1;0;2;0;-3
"ATCAGA";-5;4;1;2;-5;-3
"ATTGCG";-9;0;12;3;-9;-3
"ATTGGT";-7;-1;3;4;-2;-3
"CAAGCC";6;-4;-2;2;-5;-3
"CACCCG";-8;-6;7;1;3;-3
"CACCGT";-6;-7;-2;2;10;-3
"CACGAC";7;-6;-2;2;-4;-3
"CATACG";-6;-4;14;-2;-5;-3
"CATAGT";-4;-5;5;-1;2;-3
"CCAACC";5;-3;-4;4;-5;-3
"CCATCT";0;2;2;-7;0;-3
"CCATGA";1;5;3;-7;-5;-3
"CCCAAC";6;-5;-4;4;-4;-3
"CCCTAT";1;0;2;-7;1;-3
"CCGGAT";3;2;-6;-10;8;-3
"CCTCGG";-10;-7;8;5;1;-3
"CCTGTA";-8;3;8;3;-9;-3
"CGAACG";2;-4;5;-9;3;-3
"CGAAGT";4;-5;-4;-8;10;-3
"CGCAAG";3;-6;5;-9;4;-3
"CTAGAT";-2;2;-4;-2;3;-3
"CTCAGC";3;-1;-6;8;-7;-3
"CTCTGT";-2;4;0;-3;-2;-3
"CTGGCG";-2;7;1;-7;-2;-3
"CTGGGT";0;6;-8;-6;5;-3
"GACGTT";-8;-2;4;6;-3;-3
"GATGCA";-6;-3;6;7;-7;-3
"GCATGG";-3;0;9;-1;-8;-3
"GCCATG";-11;-1;10;6;-7;-3
"GCCATT";-9;-1;2;8;-3;-3
"GCCCCA";-9;-4;-3;12;1;-3
"GCTACA";-7;-2;4;9;-7;-3
"GCTGTG";-12;-2;14;9;-12;-3
"GGAGCA";2;-3;-3;0;1;-3
"GGCGAA";3;-5;-3;0;2;-3
"TAAGGG";0;1;6;-10;0;-3
"TCAAGG";-1;2;4;-8;0;-3
"TGCGCT";5;-3;-6;-9;10;-3
"TTCGCA";-2;8;-4;-2;-3;-3
"AACACA";-3;0;6;-2;-3;-2
"AACGTG";-8;0;16;-2;-8;-2
"AATGCT";-5;-5;8;0;0;-2
"AATGGA";-4;-2;9;0;-5;-2
"ACCATG";-9;1;14;0;-8;-2
"ACCCCT";-8;-6;-1;5;8;-2
"ACCCGA";-7;-3;0;5;3;-2
"ACTACT";-6;-4;6;2;0;-2
"ACTAGA";-5;-1;7;2;-5;-2
"AGAGCT";3;-5;-1;-7;8;-2
"AGAGGA";4;-2;0;-7;3;-2
"AGCGAT";4;-7;-1;-7;9;-2
"ATCGCC";2;-1;-3;9;-9;-2
"CAAGAA";1;1;2;-6;0;-2
"CACACC";5;-5;-1;4;-5;-2
"CACTCG";-2;0;13;-6;-7;-2
"CACTGA";1;3;6;-7;-5;-2
"CAGGCT";2;2;-3;-10;7;-2
"CAGGGA";3;5;-2;-10;2;-2
"CATGGC";4;-7;2;6;-7;-2
"CCAAAA";0;2;0;-4;0;-2
"CCCCGC";1;-8;-7;11;1;-2
"CCGACT";1;3;-5;-8;7;-2
"CCGAGA";2;6;-4;-8;2;-2
"CCTAGC";3;-6;0;8;-7;-2
"CCTTCG";-4;0;15;-4;-9;-2
"CCTTGT";-2;-1;6;-3;-2;-2
"CGAGGC";12;-7;-7;-1;1;-2
"CGCCGG";-2;-9;2;-2;9;-2
"CGCGTA";0;1;2;-4;-1;-2
"CGTAGG";0;-7;9;-5;1;-2
"CTAACT";-4;3;-3;0;2;-2
"CTAAGA";-3;6;-2;0;-3;-2
"CTCAAT";-3;1;-3;0;3;-2
"CTTGAG";-6;0;9;1;-6;-2
"GAAGAG";-3;-4;8;0;-3;-2
"GACTGG";-3;-2;12;-1;-8;-2
"GAGGGG";-1;0;4;-4;-1;-2
"GCAAAG";-4;-3;6;2;-3;-2
"GCGAGG";-2;1;2;-2;-1;-2
"GGCACA";1;-4;-2;2;1;-2
"GGTGCT";-1;-9;0;4;4;-2
"GGTGGA";0;-6;1;4;-1;-2
"GTAAGG";-7;1;4;6;-6;-2
"GTAGCA";-6;4;-3;7;-4;-2
"GTCGTG";-12;3;8;9;-10;-2
"TACAGG";-1;0;7;-8;0;-2
"TCCGTT";-4;4;0;-3;1;-2
"TCTGCA";-2;3;2;-2;-3;-2
"ACCTCA";-1;4;7;-4;-7;-1
"ACGGCA";1;6;-1;-7;0;-1
"ACTGCC";2;-6;3;9;-9;-1
"AGCACT";2;-6;0;-5;8;-1
"AGCAGA";3;-3;1;-5;3;-1
"AGTGCG";-1;-7;12;-4;-1;-1
"AGTGGT";1;-8;3;-3;6;-1
"ATCGAA";-3;4;1;1;-4;-1
"CAAACA";-1;2;3;-4;-1;-1
"CAAGTG";-6;2;13;-4;-6;-1
"CACAAA";0;0;3;-4;0;-1
"CACTCT";0;0;5;-6;0;-1
"CATGAT";-2;-5;5;-2;3;-1
"CCAATG";-7;3;11;-2;-6;-1
"CCACCT";-6;-4;-4;3;10;-1
"CCACGA";-5;-1;-3;3;5;-1
"CCCCAT";-5;-6;-4;3;11;-1
"CCCTCC";7;-1;0;2;-9;-1
"CCGGCC";9;1;-8;-1;-2;-1
"CCTAAT";-3;-4;3;0;3;-1
"CGAGAT";6;-5;-4;-9;11;-1
"CGCAGC";11;-8;-6;1;1;-1
"CGCTGT";6;-3;0;-10;6;-1
"CGGGCG";6;0;1;-14;6;-1
"CGGGGT";8;-1;-8;-13;13;-1
"CTAGCC";4;1;-6;7;-7;-1
"CTCCCG";-10;-1;3;6;1;-1
"CTCCGT";-8;-2;-6;7;8;-1
"CTCGAC";5;-1;-6;7;-6;-1
"CTTACG";-8;1;10;3;-7;-1
"CTTAGT";-6;0;1;4;0;-1
"GAAACG";-5;-3;9;2;-4;-1
"GAAAGT";-3;-4;0;3;3;-1
"GACAAG";-4;-5;9;2;-3;-1
"GCACGG";-9;-6;3;9;2;-1
"GCAGTA";-7;4;3;7;-8;-1
"GCCGTC";-1;-3;-1;15;-11;-1
"GTCGTT";-10;3;0;11;-5;-1
"TCAGAG";1;2;4;-9;1;-1
"TCCTGG";1;4;8;-10;-4;-1
"TCGGGG";3;6;0;-13;3;-1
"TGCGCA";6;1;-4;-9;5;-1
"TTAGGG";-2;6;2;-5;-2;-1
"AAAAGG";-3;-2;12;-5;-2;0
"ACAGTT";-6;2;5;0;-1;0
"ACTGAA";-3;-1;7;1;-4;0
"AGCGCC";10;-8;-3;2;-1;0
"ATAGCA";-4;6;1;1;-4;0
"ATCACA";-5;5;2;3;-5;0
"ATCGTG";-10;5;12;3;-10;0
"ATTGCT";-7;0;4;5;-2;0
"ATTGGA";-6;3;5;5;-7;0
"CACATG";-7;1;14;-2;-6;0
"CACCCT";-6;-6;-1;3;10;0
"CACCGA";-5;-3;0;3;5;0
"CATACT";-4;-4;6;0;2;0
"CATAGA";-3;-1;7;0;-3;0
"CCATCA";1;6;4;-6;-5;0
"CCCTAA";2;4;4;-6;-4;0
"CCGGAA";4;6;-4;-9;3;0
"CCTCCG";-10;-6;9;6;1;0
"CCTCGT";-8;-7;0;7;8;0
"CCTGAC";5;-6;0;7;-6;0
"CGAACT";4;-4;-3;-7;10;0
"CGAAGA";5;-1;-2;-7;5;0
"CGCAAT";5;-6;-3;-7;11;0
"CGTGAG";2;-7;9;-6;2;0
"CTAGAA";-1;6;-2;-1;-2;0
"CTCACC";3;0;-5;9;-7;0
"CTCTCG";-4;5;9;-1;-9;0
"CTCTGA";-1;8;2;-2;-7;0
"CTGGCT";0;7;-7;-5;5;0
"CTGGGA";1;10;-6;-5;0;0
"CTTGGC";2;-2;-2;11;-9;0
"GAAGGC";5;-6;-3;10;-6;0
"GACCGG";-9;-8;6;9;2;0
"GACGTA";-7;2;6;7;-8;0
"GATAGG";-7;-6;13;6;-6;0
"GCAAGC";4;-5;-5;12;-6;0
"GCATCG";-3;1;10;0;-8;0
"GCATGT";-1;0;1;1;-1;0
"GCCTAG";-2;-1;10;0;-7;0
"GCGGAG";0;1;2;-3;0;0
"GCTGTT";-10;-2;6;11;-5;0
"GGAAGG";1;-6;4;-1;2;0
"GGCGTG";-4;-4;8;2;-2;0
"GTAGAG";-5;1;4;5;-5;0
"GTCTGG";-5;3;8;4;-10;0
"GTGGGG";-3;5;0;1;-3;0
"TAAGCG";0;2;7;-9;0;0
"TAAGGT";2;1;-2;-8;7;0
"TACGAG";1;0;7;-9;1;0
"TCAACG";-1;3;5;-7;0;0
"TCAAGT";1;2;-4;-6;7;0
"TCCAAG";0;1;5;-7;1;0
"TTCAGG";-3;5;3;-3;-2;0
"AACGTT";-6;0;8;0;-1;1
"AATGCA";-4;-1;10;1;-5;1
"ACATGG";-1;2;13;-7;-6;1
"ACCATT";-7;1;6;2;-1;1
"ACCCCA";-7;-2;1;6;3;1
"ACTACA";-5;0;8;3;-5;1
"ACTGTG";-10;0;18;3;-10;1
"AGAGCA";4;-1;1;-6;3;1
"AGCGAA";5;-3;1;-6;4;1
"CACTCA";1;4;7;-6;-5;1
"CAGGCA";3;6;-1;-9;2;1
"CATGCC";4;-6;3;7;-7;1
"CCCCCC";1;-7;-6;12;1;1
"CCCTTG";-5;5;15;-4;-10;1
"CCGACA";2;7;-3;-7;2;1
"CCGGTG";-3;7;7;-7;-3;1
"CCTACC";3;-5;1;9;-7;1
"CCTTCT";-2;0;7;-2;-2;1
"CCTTGA";-1;3;8;-2;-7;1
"CGAGCC";12;-6;-6;0;1;1
"CGCCCG";-2;-8;3;-1;9;1
"CGCCGT";0;-9;-6;0;16;1
"CGCGAC";13;-8;-6;0;2;1
"CGTACG";0;-6;10;-4;1;1
"CGTAGT";2;-7;1;-3;8;1
"CTAACA";-3;7;-1;1;-3;1
"CTAGTG";-8;7;9;1;-8;1
"CTCAAA";-2;5;-1;1;-2;1
"CTCTCT";-2;5;1;-1;-2;1
"CTTGAT";-4;0;1;3;1;1
"GAAGAT";-1;-4;0;2;4;1
"GACAGC";4;-7;-2;12;-6;1
"GACTGT";-1;-2;4;1;-1;1
"GAGGCG";-1;1;5;-3;-1;1
"GAGGGT";1;0;-4;-2;6;1
"GCAAAT";-2;-3;-2;4;4;1
"GCCATA";-8;3;4;9;-7;1
"GCGACG";-2;2;3;-1;-1;1
"GCGAGT";0;1;-6;0;6;1
"GCTTGG";-5;-2;14;4;-10;1
"GGCGTT";-2;-4;0;4;3;1
"GGTGCA";0;-5;2;5;-1;1
"GTAACG";-7;2;5;7;-6;1
"GTAAGT";-5;1;-4;8;1;1
"GTCAAG";-6;0;5;7;-5;1
"TACAGT";1;0;-1;-6;7;1
"TATGGG";-2;-1;11;-5;-2;1
"TCAGGC";9;0;-7;1;-2;1
"TCCCGG";-5;-2;2;0;6;1
"TCCGTA";-3;8;2;-2;-4;1
"TCTAGG";-3;0;9;-3;-2;1
"TGAGGG";6;-1;2;-12;6;1
"AAAGAG";-1;-2;12;-6;-1;2
"AACTGG";-1;0;16;-7;-6;2
"AAGGGG";1;2;8;-10;1;2
"ACAAAG";-2;-1;10;-4;-1;2
"ACCGTC";1;-1;3;9;-10;2
"ACGAGG";0;3;6;-8;1;2
"AGCACA";3;-2;2;-4;3;2
"AGCGTG";-2;-2;12;-4;-2;2
"AGTGCT";1;-7;4;-2;6;2
"AGTGGA";2;-4;5;-2;1;2
"ATAAGG";-5;3;8;0;-4;2
"CAAGTT";-4;2;5;-2;1;2
"CATGAA";-1;-1;7;-1;-2;2
"CCAATT";-5;3;3;0;1;2
"CCACCA";-5;0;-2;4;5;2
"CCCCAA";-4;-2;-2;4;6;2
"CCTAAA";-2;0;5;1;-2;2
"CGAGAA";7;-1;-2;-8;6;2
"CGCACC";11;-7;-5;2;1;2
"CGCTCG";4;-2;9;-8;-1;2
"CGCTGA";7;1;2;-9;1;2
"CGGGCT";8;0;-7;-12;13;2
"CGGGGA";9;3;-6;-12;8;2
"CGTGGC";10;-9;-2;4;-1;2
"CTCATG";-9;6;10;3;-8;2
"CTCCCT";-8;-1;-5;8;8;2
"CTCCGA";-7;2;-4;8;3;2
"CTTACT";-6;1;2;5;0;2
"CTTAGA";-5;4;3;5;-5;2
"GAAACT";-3;-3;1;4;3;2
"GAAAGA";-2;0;2;4;-2;2
"GACAAT";-2;-5;1;4;4;2
"GACTCG";-3;-1;13;1;-8;2
"GATGAG";-5;-6;13;5;-5;2
"GCACCG";-9;-5;4;10;2;2
"GCACGT";-7;-6;-5;11;9;2
"GCAGAC";6;-5;-5;11;-5;2
"GCCCAG";-8;-7;4;10;3;2
"GCCTGC";6;-3;-1;10;-10;2
"GCGGGC";8;-1;-9;7;-3;2
"GCTAAG";-6;-5;11;7;-5;2
"GGAGAG";3;-6;4;-2;3;2
"GGCTGG";3;-4;8;-3;-2;2
"GGGGGG";5;-2;0;-6;5;2
"GTAGGC";3;-1;-7;15;-8;2
"GTCCGG";-11;-3;2;14;0;2
"GTCGTA";-9;7;2;12;-10;2
"GTTAGG";-9;-1;9;11;-8;2
"GTTGCA";-8;2;2;12;-6;2
"TACGGC";9;-2;-4;1;-2;2
"TCAGAT";3;2;-4;-7;8;2
"TCCAGC";8;-1;-6;3;-2;2
"TCCTGT";3;4;0;-8;3;2
"TCGGCG";3;7;1;-12;3;2
"TCGGGT";5;6;-8;-11;10;2
"TGCAGG";5;-2;3;-10;6;2
"TTAGCG";-2;7;3;-4;-2;2
"TTAGGT";0;6;-6;-3;5;2
"TTCGAG";-1;5;3;-4;-1;2
"AAAACG";-3;-1;13;-4;-2;3
"AAAAGT";-1;-2;4;-3;5;3
"AACAAG";-2;-3;13;-4;-1;3
"ACACGG";-7;-4;7;3;4;3
"ACAGTA";-5;6;7;1;-6;3
"ATCGTT";-8;5;4;5;-3;3
"CAATGG";1;2;13;-9;-4;3
"CACATT";-5;1;6;0;1;3
"CACCCA";-5;-2;1;4;5;3
"CATACA";-3;0;8;1;-3;3
"CATGTG";-8;0;18;1;-8;3
"CCAGTC";3;1;0;7;-8;3
"CCCCTG";-11;-1;9;6;0;3
"CCTATG";-9;1;16;3;-8;3
"CCTCCT";-8;-6;1;8;8;3
"CCTCGA";-7;-3;2;8;3;3
"CGAACA";5;0;-1;-6;5;3
"CGAGTG";0;0;9;-6;0;3
"CGCAAA";6;-2;-1;-6;6;3
"CGTGAT";4;-7;1;-4;9;3
"CTCTCA";-1;9;3;-1;-7;3
"CTTGCC";2;-1;-1;12;-9;3
"GAAGCC";5;-5;-2;11;-6;3
"GACCCG";-9;-7;7;10;2;3
"GACCGT";-7;-8;-2;11;9;3
"GACGAC";6;-7;-2;11;-5;3
"GATAGT";-5;-6;5;8;1;3
"GCAACC";4;-4;-4;13;-6;3
"GCATCT";-1;1;2;2;-1;3
"GCATGA";0;4;3;2;-6;3
"GCCAAC";5;-6;-4;13;-5;3
"GCCTAT";0;-1;2;2;0;3
"GCGGAT";2;1;-6;-1;7;3
"GCTCGG";-11;-8;8;14;0;3
"GCTGTA";-9;2;8;12;-10;3
"GGAACG";1;-5;5;0;2;3
"GGAAGT";3;-6;-4;1;9;3
"GGCAAG";2;-7;5;0;3;3
"GTAGAT";-3;1;-4;7;2;3
"GTCAGC";2;-2;-6;17;-8;3
"GTCTGT";-3;3;0;6;-3;3
"GTGGGT";-1;5;-8;3;4;3
"TAAGCT";2;2;-1;-7;7;3
"TAAGGA";3;5;0;-7;2;3
"TACACG";-1;1;8;-5;0;3
"TACGAT";3;0;-1;-7;8;3
"TCAACT";1;3;-3;-5;7;3
"TCAAGA";2;6;-2;-5;2;3
"TCCAAT";2;1;-3;-5;8;3
"TCTGAG";-1;0;9;-4;-1;3
"TTCAGT";-1;5;-5;-1;5;3
"TTTGGG";-4;4;7;0;-4;3
"AAAGGC";7;-4;1;4;-4;4
"AACCGG";-7;-6;10;3;4;4
"AACGTA";-5;4;10;1;-6;4
"AATAGG";-5;-4;17;0;-4;4
"ACAAGC";6;-3;-1;6;-4;4
"ACATCG";-1;3;14;-6;-6;4
"ACATGT";1;2;5;-5;1;4
"ACCATA";-6;5;8;3;-6;4
"ACCTAG";0;1;14;-6;-5;4
"ACGGAG";2;3;6;-9;2;4
"ACTGTT";-8;0;10;5;-3;4
"AGAAGG";3;-4;8;-7;4;4
"ATAGAG";-3;3;8;-1;-3;4
"ATCTGG";-3;5;12;-2;-8;4
"ATGGGG";-1;7;4;-5;-1;4
"ATTGCA";-6;4;6;6;-6;4
"CAAAAG";0;-1;10;-6;1;4
"CACGTC";3;-1;3;7;-8;4
"CAGAGG";2;3;6;-10;3;4
"CCCATC";2;0;1;9;-8;4
"CCCTTT";-3;5;7;-2;-3;4
"CCGGTT";-1;7;-1;-5;4;4
"CCTTCA";-1;4;9;-1;-7;4
"CGCATG";-1;-1;10;-4;0;4
"CGCCCT";0;-8;-5;1;16;4
"CGCCGA";1;-5;-4;1;11;4
"CGTACT";2;-6;2;-2;8;4
"CGTAGA";3;-3;3;-2;3;4
"CTAGTT";-6;7;1;3;-1;4
"CTTGAA";-3;4;3;4;-4;4
"GAAGAA";0;0;2;3;-1;4
"GACACC";4;-6;-1;13;-6;4
"GACTCT";-1;-1;5;2;-1;4
"GACTGA";0;2;6;2;-6;4
"GAGGCT";1;1;-3;-1;6;4
"GAGGGA";2;4;-2;-1;1;4
"GATGGC";3;-8;2;15;-8;4
"GCAAAA";-1;1;0;5;-1;4
"GCCCGC";0;-9;-7;20;0;4
"GCGACT";0;2;-5;1;6;4
"GCGAGA";1;5;-4;1;1;4
"GCTAGC";2;-7;0;17;-8;4
"GCTTCG";-5;-1;15;5;-10;4
"GCTTGT";-3;-2;6;6;-3;4
"GGAGGC";11;-8;-7;8;0;4
"GGCCGG";-3;-10;2;7;8;4
"GGCGTA";-1;0;2;5;-2;4
"GGTAGG";-1;-8;9;4;0;4
"GTAACT";-5;2;-3;9;1;4
"GTAAGA";-4;5;-2;9;-4;4
"GTCAAT";-4;0;-3;9;2;4
"GTCTCG";-5;4;9;6;-10;4
"GTGGCG";-3;6;1;2;-2;4
"GTTGAG";-7;-1;9;10;-7;4
"TACACT";1;1;0;-5;7;4
"TACAGA";2;4;1;-5;2;4
"TATGCG";-2;0;12;-4;-2;4
"TATGGT";0;-1;3;-3;5;4
"TCAGCC";9;1;-6;2;-2;4
"TCCCCG";-5;-1;3;1;6;4
"TCCCGT";-3;-2;-6;2;13;4
"TCCGAC";10;-1;-6;2;-1;4
"TCTACG";-3;1;10;-2;-2;4
"TCTAGT";-1;0;1;-1;5;4
"TGAGCG";6;0;3;-11;6;4
"TGAGGT";8;-1;-6;-10;13;4
"TGCGAG";7;-2;3;-11;7;4
"TTCGGC";7;3;-8;6;-4;4
"AAAGAT";1;-2;4;-4;6;5
"AACAGC";6;-5;2;6;-4;5
"AACTGT";1;0;8;-5;1;5
"AAGGCG";1;3;9;-9;1;5
"AAGGGT";3;2;0;-8;8;5
"ACAAAT";0;-1;2;-2;6;5
"ACGACG";0;4;7;-7;1;5
"ACGAGT";2;3;-2;-6;8;5
"ACTTGG";-3;0;18;-2;-8;5
"AGCGTT";0;-2;4;-2;5;5
"AGTGCA";2;-3;6;-1;1;5
"ATAACG";-5;4;9;1;-4;5
"ATAAGT";-3;3;0;2;3;5
"ATCAAG";-4;2;9;1;-3;5
"CAACGG";-5;-4;7;1;6;5
"CAAGTA";-3;6;7;-1;-4;5
"CCAATA";-4;7;5;1;-4;5
"CCATAG";2;3;11;-8;-3;5
"CCGTGG";4;7;7;-12;-1;5
"CGCTCA";7;2;3;-8;1;5
"CGGGCA";9;4;-5;-11;8;5
"CGTGCC";10;-8;-1;5;-1;5
"CTATGG";-1;7;9;-4;-6;5
"CTCATT";-7;6;2;5;-1;5
"CTCCCA";-7;3;-3;9;3;5
"CTGGCA";1;11;-5;-4;2;5
"CTTACA";-5;5;4;6;-5;5
"CTTGTG";-10;5;14;6;-10;5
"GAAACA";-2;1;3;5;-2;5
"GAAGTG";-7;1;13;5;-7;5
"GACAAA";-1;-1;3;5;-1;5
"GATGAT";-3;-6;5;7;2;5
"GCAATG";-8;2;11;7;-7;5
"GCACCT";-7;-5;-4;12;9;5
"GCACGA";-6;-2;-3;12;4;5
"GCCCAT";-6;-7;-4;12;10;5
"GCCTCC";6;-2;0;11;-10;5
"GCGGCC";8;0;-8;8;-3;5
"GCTAAT";-4;-5;3;9;2;5
"GGAGAT";5;-6;-4;0;10;5
"GGCAGC";10;-9;-6;10;0;5
"GGCTGT";5;-4;0;-1;5;5
"GGGGCG";5;-1;1;-5;5;5
"GGGGGT";7;-2;-8;-4;12;5
"GTAGCC";3;0;-6;16;-8;5
"GTCCCG";-11;-2;3;15;0;5
"GTCCGT";-9;-3;-6;16;7;5
"GTCGAC";4;-2;-6;16;-7;5
"GTTAGT";-7;-1;1;13;-1;5
"TACGCC";9;-1;-3;2;-2;5
"TCAGAA";4;6;-2;-6;3;5
"TCCACC";8;0;-5;4;-2;5
"TCCTGA";4;8;2;-7;-2;5
"TCGGCT";5;7;-7;-10;10;5
"TCGGGA";6;10;-6;-10;5;5
"TCTGGC";7;-2;-2;6;-4;5
"TGCAGT";7;-2;-5;-8;13;5
"TGTGGG";4;-3;7;-7;4;5
"TTAGCT";0;7;-5;-2;5;5
"TTAGGA";1;10;-4;-2;0;5
"TTCACG";-3;6;4;0;-2;5
"TTCGAT";1;5;-5;-2;6;5
"AAAACT";-1;-1;5;-2;5;6
"AAAAGA";0;2;6;-2;0;6
"AACAAT";0;-3;5;-2;6;6
"AACTCG";-1;1;17;-5;-6;6
"AATGAG";-3;-4;17;-1;-3;6
"ACACCG";-7;-3;8;4;4;6
"ACACGT";-5;-4;-1;5;11;6
"ACAGAC";8;-3;-1;5;-3;6
"ACCCAG";-6;-5;8;4;5;6
"ACCTGC";8;-1;3;4;-8;6
"ACGGGC";10;1;-5;1;-1;6
"ACTAAG";-4;-3;15;1;-3;6
"AGAGAG";5;-4;8;-8;5;6
"AGCTGG";5;-2;12;-9;0;6
"AGGGGG";7;0;4;-12;7;6
"ATAGGC";5;1;-3;9;-6;6
"ATCCGG";-9;-1;6;8;2;6
"ATCGTA";-7;9;6;6;-8;6
"ATTAGG";-7;1;13;5;-6;6
"CAAAGC";8;-3;-1;4;-2;6
"CAATCG";1;3;14;-8;-4;6
"CAATGT";3;2;5;-7;3;6
"CACATA";-4;5;8;1;-4;6
"CACTAG";2;1;14;-8;-3;6
"CAGGAG";4;3;6;-11;4;6
"CATGTT";-6;0;10;3;-1;6
"CCCCTT";-9;-1;1;8;7;6
"CCGAAG";3;4;4;-9;4;6
"CCTATT";-7;1;8;5;-1;6
"CCTCCA";-7;-2;3;9;3;6
"CGAGTT";2;0;1;-4;7;6
"CGTGAA";5;-3;3;-3;4;6
"CTAAAG";-2;4;6;-1;-1;6
"CTCGTC";1;4;-1;12;-10;6
"CTGAGG";0;8;2;-5;1;6
"GACCCT";-7;-7;-1;12;9;6
"GACCGA";-6;-4;0;12;4;6
"GATACG";-4;-5;14;7;-6;6
"GATAGA";-4;-2;7;9;-4;6
"GCATCA";0;5;4;3;-6;6
"GCCTAA";1;3;4;3;-5;6
"GCGGAA";3;5;-4;0;2;6
"GCTCCG";-11;-7;9;15;0;6
"GCTCGT";-9;-8;0;16;7;6
"GCTGAC";4;-7;0;16;-7;6
"GGAACT";3;-5;-3;2;9;6
"GGAAGA";4;-2;-2;2;4;6
"GGCAAT";4;-7;-3;2;10;6
"GGCTCG";3;-3;9;-1;-2;6
"GGTGAG";1;-8;9;3;1;6
"GTAGAA";-2;5;-2;8;-3;6
"GTCACC";2;-1;-5;18;-8;6
"GTCTCT";-3;4;1;7;-3;6
"GTCTGA";-2;7;2;7;-8;6
"GTGGCT";-1;6;-7;4;4;6
"GTGGGA";0;9;-6;4;-1;6
"GTTGGC";1;-3;-2;20;-10;6
"TAAGCA";3;6;1;-6;2;6
"TACGAA";4;4;1;-6;3;6
"TCAACA";2;7;-1;-4;2;6
"TCAGTG";-3;7;9;-4;-3;6
"TCCAAA";3;5;-1;-4;3;6
"TCTGAT";1;0;1;-2;6;6
"TGCGGC";15;-4;-8;-1;4;6
"TTCACT";-1;6;-4;0;5;6
"TTCAGA";0;9;-3;0;0;6
"TTTGCG";-4;5;8;1;-4;6
"TTTGGT";-2;4;-1;2;3;6
"AAAGCC";7;-3;2;5;-4;7
"AACCCG";-7;-5;11;4;4;7
"AACCGT";-5;-6;2;5;11;7
"AACGAC";8;-5;2;5;-3;7
"AATACG";-5;-3;18;1;-4;7
"AATAGT";-3;-4;9;2;3;7
"ACAACC";6;-2;0;7;-4;7
"ACATCT";1;3;6;-4;1;7
"ACATGA";2;6;7;-4;-4;7
"ACCAAC";7;-4;0;7;-3;7
"ACCTAT";2;1;6;-4;2;7
"ACGGAT";4;3;-2;-7;9;7
"ACTCGG";-9;-6;12;8;2;7
"ACTGTA";-7;4;12;6;-8;7
"AGAACG";3;-3;9;-6;4;7
"AGAAGT";5;-4;0;-5;11;7
"AGCAAG";4;-5;9;-6;5;7
"ATAGAT";-1;3;0;1;4;7
"ATCAGC";4;0;-2;11;-6;7
"ATCTGT";-1;5;4;0;-1;7
"ATGGCG";-1;8;5;-4;-1;7
"ATGGGT";1;7;-4;-3;6;7
"CAAAAT";2;-1;2;-4;8;7
"CAGACG";2;4;7;-9;3;7
"CAGAGT";4;3;-2;-8;10;7
"CATTGG";-1;0;18;-4;-6;7
"CCACAG";-4;-3;5;2;7;7
"CCATGC";10;1;0;2;-6;7
"CCCTTA";-2;9;9;-1;-8;7
"CCGCGG";-2;1;1;-2;9;7
"CCGGTA";0;11;1;-4;-1;7
"CCTGTC";1;-1;5;12;-10;7
"CGATGG";7;0;9;-11;2;7
"CGCATT";1;-1;2;-2;7;7
"CGCCCA";1;-4;-3;2;11;7
"CGCTCT";6;-2;1;-4;6;7
"CGTACA";3;-2;4;-1;3;7
"CGTGTG";-2;-2;14;-1;-2;7
"CTACGG";-7;1;3;6;4;7
"CTAGTA";-5;11;3;4;-6;7
"GACTCA";0;3;7;3;-6;7
"GAGGCA";2;5;-1;0;1;7
"GATACT";-4;-5;6;9;1;7
"GATGCC";3;-7;3;16;-8;7
"GCCCCC";0;-8;-6;21;0;7
"GCCTTG";-6;4;15;5;-11;7
"GCGACA";1;6;-3;2;1;7
"GCGGTG";-4;6;7;2;-4;7
"GCTACC";2;-6;1;18;-8;7
"GCTTCT";-3;-1;7;7;-3;7
"GCTTGA";-2;2;8;7;-8;7
"GGAGCC";11;-7;-6;9;0;7
"GGCCCG";-3;-9;3;8;8;7
"GGCCGT";-1;-10;-6;9;15;7
"GGCGAC";12;-9;-6;9;1;7
"GGTAGT";1;-8;1;6;7;7
"GTAACA";-4;6;-1;10;-4;7
"GTAGTG";-9;6;9;10;-9;7
"GTCAAA";-3;4;-1;10;-3;7
"GTTGAT";-5;-1;1;12;0;7
"TACACA";2;5;2;-4;2;7
"TACGTG";-3;5;12;-4;-3;7
"TATGCT";0;0;4;-2;5;7
"TATGGA";1;3;5;-2;0;7
"TCCATG";-4;6;10;-2;-3;7
"TCCCCT";-3;-1;-5;3;13;7
"TCCCGA";-2;2;-4;3;8;7
"TCTACT";-1;1;2;0;5;7
"TCTAGA";0;4;3;0;0;7
"TGAGCT";8;0;-5;-9;13;7
"TGAGGA";9;3;-4;-9;8;7
"TGCACG";5;-1;4;-7;6;7
"TGCGAT";9;-2;-5;-9;14;7
"TTCGCC";7;4;-7;7;-4;7
"AAAGAA";2;2;6;-3;1;8
"AACACC";6;-4;3;7;-4;8
"AACTCT";1;1;9;-4;1;8
"AACTGA";2;4;10;-4;-4;8
"AAGGCT";3;3;1;-7;8;8
"AAGGGA";4;6;2;-7;3;8
"AATGGC";5;-6;6;9;-6;8
"ACAAAA";1;3;4;-1;1;8
"ACCCGC";2;-7;-3;14;2;8
"ACGACT";2;4;-1;-5;8;8
"ACGAGA";3;7;0;-5;3;8
"ACTAGC";4;-5;4;11;-6;8
"ACTTCG";-3;1;19;-1;-8;8
"ACTTGT";-1;0;10;0;-1;8
"AGAGGC";13;-6;-3;2;2;8
"AGCCGG";-1;-8;6;1;10;8
"AGCGTA";1;2;6;-1;0;8
"AGTAGG";1;-6;13;-2;2;8
"ATAACT";-3;4;1;3;3;8
"ATAAGA";-2;7;2;3;-2;8
"ATCAAT";-2;2;1;3;4;8
"ATCTCG";-3;6;13;0;-8;8
"ATTGAG";-5;1;13;4;-5;8
"CAACCG";-5;-3;8;2;6;8
"CAACGT";-3;-4;-1;3;13;8
"CAAGAC";10;-3;-1;3;-1;8
"CACCAG";-4;-5;8;2;7;8
"CACTGC";10;-1;3;2;-6;8
"CAGGGC";12;1;-5;-1;1;8
"CATAAG";-2;-3;15;-1;-1;8
"CCAAAC";9;-2;-3;5;-1;8
"CCATAT";4;3;3;-6;4;8
"CCGAGC";11;2;-7;1;1;8
"CCGTCG";4;8;8;-11;-1;8
"CCGTGT";6;7;-1;-10;6;8
"CGAAAG";6;-3;6;-8;7;8
"CGCGTC";9;-3;-1;5;-2;8
"CGGAGG";8;1;2;-12;9;8
"CTAAGC";6;2;-5;9;-4;8
"CTATCG";-1;8;10;-3;-6;8
"CTATGT";1;7;1;-2;1;8
"CTCATA";-6;10;4;6;-6;8
"CTCTAG";0;6;10;-3;-5;8
"CTGGAG";2;8;2;-6;2;8
"CTTGTT";-8;5;6;8;-3;8
"GAAGTT";-5;1;5;7;0;8
"GATGAA";-2;-2;7;8;-3;8
"GCAATT";-6;2;3;9;0;8
"GCACCA";-6;-1;-2;13;4;8
"GCCCAA";-5;-3;-2;13;5;8
"GCTAAA";-3;-1;5;10;-3;8
"GGAGAA";6;-2;-2;1;5;8
"GGCACC";10;-8;-5;11;0;8
"GGCTCT";5;-3;1;0;5;8
"GGCTGA";6;0;2;0;0;8
"GGGGCT";7;-1;-7;-3;12;8
"GGGGGA";8;2;-6;-3;7;8
"GGTGGC";9;-10;-2;13;-2;8
"GTCCCT";-9;-2;-5;17;7;8
"GTCCGA";-8;1;-4;17;2;8
"GTTACG";-6;0;10;12;-8;8
"GTTAGA";-6;3;3;14;-6;8
"TCGGCA";6;11;-5;-9;5;8
"TCTGCC";7;-1;-1;7;-4;8
"TGCACT";7;-1;-4;-7;13;8
"TGCAGA";8;2;-3;-7;8;8
"TGTGCG";4;-2;8;-6;4;8
"TGTGGT";6;-3;-1;-5;11;8
"TTAGCA";1;11;-3;-1;0;8
"TTCGAA";2;9;-3;-1;1;8
"AAAACA";0;3;7;-1;0;9
"AAAGTG";-5;3;17;-1;-5;9
"AACAAA";1;1;7;-1;1;9
"AATGAT";-1;-4;9;1;4;9
"ACAATG";-6;4;15;1;-5;9
"ACACCT";-5;-3;0;6;11;9
"ACACGA";-4;0;1;6;6;9
"ACCCAT";-4;-5;0;6;12;9
"ACCTCC";8;0;4;5;-8;9
"ACGGCC";10;2;-4;2;-1;9
"ACTAAT";-2;-3;7;3;4;9
"AGAGAT";7;-4;0;-6;12;9
"AGCAGC";12;-7;-2;4;2;9
"AGCTGT";7;-2;4;-7;7;9
"AGGGCG";7;1;5;-11;7;9
"AGGGGT";9;0;-4;-10;14;9
"ATAGCC";5;2;-2;10;-6;9
"ATCCCG";-9;0;7;9;2;9
"ATCCGT";-7;-1;-2;10;9;9
"ATCGAC";6;0;-2;10;-5;9
"ATTACG";-7;2;14;6;-6;9
"ATTAGT";-5;1;5;7;1;9
"CAAACC";8;-2;0;5;-2;9
"CAATCT";3;3;6;-6;3;9
"CAATGA";4;6;7;-6;-2;9
"CACAAC";9;-4;0;5;-1;9
"CACTAT";4;1;6;-6;4;9
"CAGGAT";6;3;-2;-9;11;9
"CATCGG";-7;-6;12;6;4;9
"CATGTA";-5;4;12;4;-6;9
"CCACGC";4;-5;-6;12;4;9
"CCCCTA";-8;3;3;9;2;9
"CCGAAT";5;4;-4;-7;11;9
"CCTATA";-6;5;10;6;-6;9
"CCTTAG";0;1;16;-3;-5;9
"CGACGG";1;-6;3;-1;12;9
"CGAGTA";3;4;3;-3;2;9
"CTAAAT";0;4;-2;1;6;9
"CTGACG";0;9;3;-4;1;9
"CTGAGT";2;8;-6;-3;8;9
"CTTTGG";-3;5;14;1;-8;9
"GAATGG";0;1;13;0;-5;9
"GACATG";-8;0;14;7;-4;9
"GACATT";-6;0;6;9;0;9
"GACCCA";-6;-3;1;13;4;9
"GATACA";-4;-1;8;10;-4;9
"GATGTG";-9;-1;18;10;-9;9
"GCAGTC";2;0;0;16;-9;9
"GCCCTG";-12;-2;9;15;-1;9
"GCTATG";-10;0;16;12;-9;9
"GCTCCT";-9;-7;1;17;7;9
"GCTCGA";-8;-4;2;17;2;9
"GGAACA";4;-1;-1;3;4;9
"GGAGTG";-1;-1;9;3;-1;9
"GGCAAA";5;-3;-1;3;5;9
"GGTGAT";3;-8;1;5;8;9
"GTCTCA";-2;8;3;8;-8;9
"GTTACT";-6;0;2;14;-1;9
"GTTGCC";1;-2;-1;21;-10;9
"TAAAGG";2;3;8;-7;3;9
"TCAGTT";-1;7;1;-2;4;9
"TCTGAA";2;4;3;-1;1;9
"TGCGCC";15;-3;-7;0;4;9
"TTCACA";0;10;-2;1;0;9
"TTCGTG";-5;10;8;1;-5;9
"TTTGCT";-2;5;0;3;3;9
"TTTGGA";-1;8;1;3;-2;9
"AACATG";-6;2;18;1;-5;10
"AACCCT";-5;-5;3;6;11;10
"AACCGA";-4;-2;4;6;6;10
"AATACT";-3;-3;10;3;3;10
"AATAGA";-2;0;11;3;-2;10
"ACATCA";2;7;8;-3;-4;10
"ACCTAA";3;5;8;-3;-3;10
"ACGGAA";5;7;0;-6;4;10
"ACTCCG";-9;-5;13;9;2;10
"ACTCGT";-7;-6;4;10;9;10
"ACTGAC";6;-5;4;10;-5;10
"AGAACT";5;-3;1;-4;11;10
"AGAAGA";6;0;2;-4;6;10
"AGCAAT";6;-5;1;-4;12;10
"AGCTCG";5;-1;13;-7;0;10
"AGTGAG";3;-6;13;-3;3;10
"ATAGAA";0;7;2;2;-1;10
"ATCACC";4;1;-1;12;-6;10
"ATCTCT";-1;6;5;1;-1;10
"ATCTGA";0;9;6;1;-6;10
"ATGGCT";1;8;-3;-2;6;10
"ATGGGA";2;11;-2;-2;1;10
"ATTGGC";3;-1;2;14;-8;10
"CAAAAA";3;3;4;-3;3;10
"CACCGC";4;-7;-3;12;4;10
"CAGACT";4;4;-1;-7;10;10
"CAGAGA";5;7;0;-7;5;10
"CATAGC";6;-5;4;9;-4;10
"CATTCG";-1;1;19;-3;-6;10
"CATTGT";1;0;10;-2;1;10
"CCACAT";-2;-3;-3;4;14;10
"CCATCC";10;2;1;3;-6;10
"CCCTAC";11;0;1;3;-5;10
"CCGCCG";-2;2;2;-1;9;10
"CCGCGT";0;1;-7;0;16;10
"CCGGAC";13;2;-7;0;2;10
"CGAAGC";14;-5;-5;2;4;10
"CGATCG";7;1;10;-10;2;10
"CGATGT";9;0;1;-9;9;10
"CGCATA";2;3;4;-1;2;10
"CGCTAG";8;-1;10;-10;3;10
"CGGGAG";10;1;2;-13;10;10
"CGTGTT";0;-2;6;1;5;10
"CTACCG";-7;2;4;7;4;10
"CTACGT";-5;1;-5;8;11;10
"CTAGAC";8;2;-5;8;-3;10
"CTCCAG";-6;0;4;7;5;10
"CTCTGC";8;4;-1;7;-8;10
"CTGGGC";10;6;-9;4;-1;10
"CTTAAG";-4;2;11;4;-3;10
"GAAAAG";-1;-2;10;3;0;10
"GAGAGG";1;2;6;-1;2;10
"GCCTTT";-4;4;7;7;-4;10
"GCGGTT";-2;6;-1;4;3;10
"GCTTCA";-2;3;9;8;-8;10
"GGCCCT";-1;-9;-5;10;15;10
"GGCCGA";0;-6;-4;10;10;10
"GGTACG";2;-7;10;5;0;10
"GGTAGA";2;-4;3;7;2;10
"GTAGTT";-7;6;1;12;-2;10
"GTTGAA";-4;3;3;13;-5;10
"TACGTT";-1;5;4;-2;4;10
"TATGCA";1;4;6;-1;0;10
"TCATGG";4;7;9;-9;-1;10
"TCCATT";-2;6;2;0;4;10
"TCCCCA";-2;3;-3;4;8;10
"TCCTCG";1;5;9;-1;-4;10
"TCTACA";0;5;4;1;0;10
"TCTGTG";-5;5;14;1;-5;10
"TGAGCA";9;4;-3;-8;8;10
"TGCGAA";10;2;-3;-8;9;10
"AACTCA";2;5;11;-3;-4;11
"AAGGCA";4;7;3;-6;3;11
"AATGCC";5;-5;7;10;-6;11
"ACCCCC";2;-6;-2;15;2;11
"ACCTTG";-4;6;19;-1;-9;11
"ACGACA";3;8;1;-4;3;11
"ACGGTG";-2;8;11;-4;-2;11
"ACTACC";4;-4;5;12;-6;11
"ACTTCT";-1;1;11;1;-1;11
"ACTTGA";0;4;12;1;-6;11
"AGAGCC";13;-5;-2;3;2;11
"AGCCCG";-1;-7;7;2;10;11
"AGCCGT";1;-8;-2;3;17;11
"AGCGAC";14;-7;-2;3;3;11
"AGTACG";1;-5;14;-1;2;11
"AGTAGT";3;-6;5;0;9;11
"ATAACA";-2;8;3;4;-2;11
"ATAGTG";-7;8;13;4;-7;11
"ATCAAA";-1;6;3;4;-1;11
"ATTGAT";-3;1;5;6;2;11
"CAAATG";-4;4;15;-1;-3;11
"CAACCT";-3;-3;0;4;13;11
"CAACGA";-2;0;1;4;8;11
"CACCAT";-2;-5;0;4;14;11
"CACTCC";10;0;4;3;-6;11
"CAGGCC";12;2;-4;0;1;11
"CATAAT";0;-3;7;1;6;11
"CCATAA";5;7;5;-5;-1;11
"CCGACC";11;3;-6;2;1;11
"CCGTCT";6;8;0;-9;6;11
"CCGTGA";7;11;1;-9;1;11
"CCTCAG";-6;-5;10;7;5;11
"CCTTGC";8;-1;5;7;-8;11
"CGAAAT";8;-3;-2;-6;14;11
"CGGACG";8;2;3;-11;9;11
"CGGAGT";10;1;-6;-10;16;11
"CGTTGG";5;-2;14;-6;0;11
"CTAACC";6;3;-4;10;-4;11
"CTATCT";1;8;2;-1;1;11
"CTATGA";2;11;3;-1;-4;11
"CTCAAC";7;1;-4;10;-3;11
"CTCTAT";2;6;2;-1;2;11
"CTGGAT";4;8;-6;-4;9;11
"CTTCGG";-9;-1;8;11;2;11
"CTTGTA";-7;9;8;9;-8;11
"GAACGG";-6;-5;7;10;5;11
"GAAGTA";-4;5;7;8;-5;11
"GACGTC";2;-2;3;16;-8;11
"GCAATA";-5;6;5;10;-5;11
"GCATAG";1;2;11;1;-4;11
"GCGTGG";3;6;7;-3;-2;11
"GGCTCA";6;1;3;1;0;11
"GGGGCA";8;3;-5;-2;7;11
"GGTACT";2;-7;2;7;7;11
"GGTGCC";9;-9;-1;14;-2;11
"GTATGG";-2;6;9;5;-7;11
"GTCATG";-10;5;10;12;-6;11
"GTCATT";-8;5;2;14;-2;11
"GTCCCA";-8;2;-3;18;2;11
"GTTACA";-6;4;4;15;-6;11
"GTTGTG";-11;4;14;15;-11;11
"TAAGAG";4;3;8;-8;4;11
"TACTGG";4;5;12;-9;-1;11
"TAGGGG";6;7;4;-12;6;11
"TCAAAG";3;4;6;-6;4;11
"TCCGTC";6;4;-1;7;-5;11
"TCCTCT";3;5;1;-1;3;11
"TCGAGG";5;8;2;-10;6;11
"TGCACA";8;3;-2;-6;8;11
"TGCGTG";3;3;8;-6;3;11
"TGTGCT";6;-2;0;-4;11;11
"TGTGGA";7;1;1;-4;6;11
"TTAAGG";0;8;4;-2;1;11
"AAAGTT";-3;3;9;1;2;12
"AATGAA";0;0;11;2;-1;12
"ACAATT";-4;4;7;3;2;12
"ACACCA";-4;1;2;7;6;12
"ACCCAA";-3;-1;2;7;7;12
"ACTAAA";-1;1;9;4;-1;12
"AGAGAA";8;0;2;-5;7;12
"AGCACC";12;-6;-1;5;2;12
"AGCTGA";8;2;6;-6;2;12
"AGGGCT";9;1;-3;-9;14;12
"AGGGGA";10;4;-2;-9;9;12
"AGTGGC";11;-8;2;7;0;12
"ATCATG";-8;7;14;6;-7;12
"ATCCCT";-7;0;-1;11;9;12
"ATCCGA";-6;3;0;11;4;12
"ATTACT";-5;2;6;8;1;12
"ATTAGA";-4;5;7;8;-4;12
"CAATCA";4;7;8;-5;-2;12
"CACTAA";5;5;8;-5;-1;12
"CAGGAA";7;7;0;-8;6;12
"CATCCG";-7;-5;13;7;4;12
"CATCGT";-5;-6;4;8;11;12
"CATGAC";8;-5;4;8;-3;12
"CCACCC";4;-4;-5;13;4;12
"CCATTG";-2;8;16;-3;-7;12
"CCCCAC";5;-6;-5;13;5;12
"CCGAAA";6;8;-2;-6;6;12
"CCTAAC";7;-4;2;10;-3;12
"CCTTAT";2;1;8;-1;2;12
"CGACCG";1;-5;4;0;12;12
"CGACGT";3;-6;-5;1;19;12
"CGAGAC";16;-5;-5;1;5;12
"CGCCAG";2;-7;4;0;13;12
"CGCTGC";16;-3;-1;0;0;12
"CGGGGC";18;-1;-9;-3;7;12
"CGTAAG";4;-5;11;-3;5;12
"CTAAAA";1;8;0;2;1;12
"CTCCGC";2;-2;-7;17;2;12
"CTGACT";2;9;-5;-2;8;12
"CTGAGA";3;12;-4;-2;3;12
"CTTAGC";4;0;0;14;-6;12
"CTTTCG";-3;6;15;2;-8;12
"CTTTGT";-1;5;6;3;-1;12
"GAAAGC";7;-4;-1;13;-3;12
"GAATCG";0;2;14;1;-5;12
"GAATGT";2;1;5;2;2;12
"GACTAG";1;0;14;1;-4;12
"GAGGAG";3;2;6;-2;3;12
"GATGTT";-7;-1;10;12;-2;12
"GCCATC";1;-1;1;18;-7;12
"GCCCTT";-10;-2;1;17;6;12
"GCGAAG";2;3;4;0;3;12
"GCTATT";-8;0;8;14;-2;12
"GCTCCA";-8;-3;3;18;2;12
"GGAGTT";1;-1;1;5;6;12
"GGTGAA";4;-4;3;6;3;12
"GTAAAG";-3;3;6;8;-2;12
"GTGAGG";-1;7;2;4;0;12
"GTGGCA";0;10;-5;5;2;12
"TAAACG";2;4;9;-6;3;12
"TAAAGT";4;3;0;-5;10;12
"TACAAG";3;2;9;-6;4;12
"TCACGG";-2;1;3;1;9;12
"TCAGTA";0;11;3;-1;-1;12
"TTCGTT";-3;10;0;3;2;12
"TTTGCA";-1;9;2;4;-2;12
"AAATGG";2;3;17;-6;-3;13
"AACATT";-4;2;10;3;2;13
"AACCCA";-4;-1;5;7;6;13
"AATACA";-2;1;12;4;-2;13
"AATGTG";-7;1;22;4;-7;13
"ACAGTC";4;2;4;10;-7;13
"ACCCTG";-10;0;13;9;1;13
"ACTATG";-8;2;20;6;-7;13
"ACTCCT";-7;-5;5;11;9;13
"ACTCGA";-6;-2;6;11;4;13
"AGAACA";6;1;3;-3;6;13
"AGAGTG";1;1;13;-3;1;13
"AGCAAA";7;-1;3;-3;7;13
"AGTGAT";5;-6;5;-1;10;13
"ATCTCA";0;10;7;2;-6;13
"ATTGCC";3;0;3;15;-8;13
"CACCCC";4;-6;-2;13;4;13
"CACTTG";-2;6;19;-3;-7;13
"CAGACA";5;8;1;-6;5;13
"CAGGTG";0;8;11;-6;0;13
"CATACC";6;-4;5;10;-4;13
"CATTCT";1;1;11;-1;1;13
"CATTGA";2;4;12;-1;-4;13
"CCACAA";-1;1;-1;5;9;13
"CCGATG";-1;9;9;-4;0;13
"CCGCCT";0;2;-6;1;16;13
"CCGCGA";1;5;-5;1;11;13
"CCTCGC";2;-7;-1;17;2;13
"CGAACC";14;-4;-4;3;4;13
"CGATGA";10;4;3;-8;4;13
"CGCAAC";15;-6;-4;3;5;13
"CGCTAT";10;-1;2;-8;10;13
"CGGGAT";12;1;-6;-11;17;13
"CGTCGG";-1;-8;8;4;10;13
"CGTGTA";1;2;8;2;0;13
"CTAATG";-6;9;11;4;-5;13
"CTACCT";-5;2;-4;9;11;13
"CTACGA";-4;5;-3;9;6;13
"CTCCAT";-4;0;-4;9;12;13
"CTCTCC";8;5;0;8;-8;13
"CTGGCC";10;7;-8;5;-1;13
"CTTAAT";-2;2;3;6;4;13
"GAAAAT";1;-2;2;5;7;13
"GACATA";-5;4;8;10;-4;13
"GAGACG";1;3;7;0;2;13
"GAGAGT";3;2;-2;1;9;13
"GATTGG";-2;-1;18;5;-7;13
"GCACAG";-5;-4;5;11;6;13
"GCATGC";9;0;0;11;-7;13
"GCCTTA";-3;8;9;8;-9;13
"GCGCGG";-3;0;1;7;8;13
"GCGGTA";-1;10;1;5;-2;13
"GCTGTC";0;-2;5;21;-11;13
"GGATGG";6;-1;9;-2;1;13
"GGCATG";-2;-2;10;5;2;13
"GGCATT";0;-2;2;7;6;13
"GGCCCA";0;-5;-3;11;10;13
"GGTACA";2;-3;4;8;2;13
"GGTGTG";-3;-3;14;8;-3;13
"GTACGG";-8;0;3;15;3;13
"GTAGTA";-6;10;3;13;-7;13
"GTCGTC";0;3;-1;21;-10;13
"TAAGGC";12;1;-3;2;1;13
"TACCGG";-2;-1;6;1;9;13
"TACGTA";0;9;6;-1;-1;13
"TATAGG";0;1;13;-2;1;13
"TCAAGC";11;2;-5;4;1;13
"TCATCG";4;8;10;-8;-1;13
"TCATGT";6;7;1;-7;6;13
"TCCATA";-1;10;4;1;-1;13
"TCCTAG";5;6;10;-8;0;13
"TCCTCA";4;9;3;-1;-2;13
"TCGGAG";7;8;2;-11;7;13
"TCTGTT";-3;5;6;3;2;13
"TGAAGG";8;1;4;-9;9;13
"TTAGAG";2;8;4;-3;2;13
"TTCTGG";2;10;8;-4;-3;13
"TTGGGG";4;12;0;-7;4;13
"AAAAAG";1;0;14;-3;2;14
"AACGTC";4;0;7;10;-7;14
"AAGAGG";3;4;10;-7;4;14
"ACCATC";3;1;5;12;-7;14
"ACCTTT";-2;6;11;1;-2;14
"ACGGTT";0;8;3;-2;5;14
"ACTTCA";0;5;13;2;-6;14
"AGCATG";0;0;14;-1;1;14
"AGCCCT";1;-7;-1;4;17;14
"AGCCGA";2;-4;0;4;12;14
"AGCTCT";7;-1;5;-4;7;14
"AGTACT";3;-5;6;1;9;14
"AGTAGA";4;-2;7;1;4;14
"ATAGTT";-5;8;5;6;0;14
"ATGGCA";2;12;-1;-1;2;14
"ATTGAA";-2;5;7;7;-3;14
"CAAATT";-2;4;7;1;4;14
"CAACCA";-2;1;2;5;8;14
"CACCAA";-1;-1;2;5;9;14
"CATAAA";1;1;9;2;1;14
"CCACTG";-8;2;10;7;3;14
"CCGTCA";7;12;2;-8;1;14
"CCTCAT";-4;-5;2;9;12;14
"CCTTCC";8;0;6;8;-8;14
"CGAAAA";9;1;0;-5;9;14
"CGCCGC";10;-9;-7;10;10;14
"CGGACT";10;2;-5;-9;16;14
"CGGAGA";11;5;-4;-9;11;14
"CGTAGC";12;-7;0;7;2;14
"CGTTCG";5;-1;15;-5;0;14
"CGTTGT";7;-2;6;-4;7;14
"CTATCA";2;12;4;0;-4;14
"CTCTAA";3;10;4;0;-3;14
"CTGGAA";5;12;-4;-3;4;14
"CTTCCG";-9;0;9;12;2;14
"CTTCGT";-7;-1;0;13;9;14
"CTTGAC";6;0;0;13;-5;14
"GAACCG";-6;-4;8;11;5;14
"GAACGT";-4;-5;-1;12;12;14
"GAAGAC";9;-4;-1;12;-2;14
"GACCAG";-5;-6;8;11;6;14
"GACTGC";9;-2;3;11;-7;14
"GAGGGC";11;0;-5;8;0;14
"GATAAG";-3;-4;15;8;-2;14
"GCAAAC";8;-3;-3;14;-2;14
"GCATAT";3;2;3;3;3;14
"GCGAGC";10;1;-7;10;0;14
"GCGTCG";3;7;8;-2;-2;14
"GCGTGT";5;6;-1;-1;5;14
"GGAAAG";5;-4;6;1;6;14
"GGGAGG";7;0;2;-3;8;14
"GTAAGC";5;1;-5;18;-5;14
"GTATCG";-2;7;10;6;-7;14
"GTATGT";0;6;1;7;0;14
"GTCTAG";-1;5;10;6;-6;14
"GTGGAG";1;7;2;3;1;14
"GTTGTT";-9;4;6;17;-4;14
"TAAGAT";6;3;0;-6;11;14
"TACAGC";11;0;-2;4;1;14
"TACTGT";6;5;4;-7;6;14
"TAGGCG";6;8;5;-11;6;14
"TAGGGT";8;7;-4;-10;13;14
"TCAAAT";5;4;-2;-4;11;14
"TCGACG";5;9;3;-9;6;14
"TCGAGT";7;8;-6;-8;13;14
"TCTTGG";2;5;14;-4;-3;14
"TGCGTT";5;3;0;-4;10;14
"TGTGCA";7;2;2;-3;6;14
"TTAACG";0;9;5;-1;1;14
"TTAAGT";2;8;-4;0;8;14
"TTCAAG";1;7;5;-1;2;14
"AAACGG";-4;-3;11;4;7;15
"AAAGTA";-2;7;11;2;-3;15
"ACAATA";-3;8;9;4;-3;15
"ACATAG";3;4;15;-5;-2;15
"ACGTGG";5;8;11;-9;0;15
"AGCTCA";8;3;7;-5;2;15
"AGGGCA";10;5;-1;-8;9;15
"AGTGCC";11;-7;3;8;0;15
"ATATGG";0;8;13;-1;-5;15
"ATCATT";-6;7;6;8;0;15
"ATCCCA";-6;4;1;12;4;15
"ATTACA";-4;6;8;9;-4;15
"ATTGTG";-9;6;18;9;-9;15
"CAAGTC";6;2;4;8;-5;15
"CACCTG";-8;0;13;7;3;15
"CATATG";-6;2;20;4;-5;15
"CATCCT";-5;-5;5;9;11;15
"CATCGA";-4;-2;6;9;6;15
"CCAATC";5;3;2;10;-5;15
"CCATTT";0;8;8;-1;0;15
"CCTTAA";3;5;10;0;-3;15
"CGAATG";2;2;11;-3;3;15
"CGACCT";3;-5;-4;2;19;15
"CGACGA";4;-2;-3;2;14;15
"CGCCAT";4;-7;-4;2;20;15
"CGCTCC";16;-2;0;1;0;15
"CGGGCC";18;0;-8;-2;7;15
"CGTAAT";6;-5;3;-1;12;15
"CTCCCC";2;-1;-6;18;2;15
"CTCTTG";-4;11;15;2;-9;15
"CTGACA";3;13;-3;-1;3;15
"CTGGTG";-2;13;7;-1;-2;15
"CTTACC";4;1;1;15;-6;15
"CTTTCT";-1;6;7;4;-1;15
"CTTTGA";0;9;8;4;-6;15
"GAAACC";7;-3;0;14;-3;15
"GAATCT";2;2;6;3;2;15
"GAATGA";3;5;7;3;-3;15
"GACAAC";8;-5;0;14;-2;15
"GACTAT";3;0;6;3;3;15
"GAGGAT";5;2;-2;0;10;15
"GATCGG";-8;-7;12;15;3;15
"GATGTA";-6;3;12;13;-7;15
"GCACGC";3;-6;-6;21;3;15
"GCCCTA";-9;2;3;18;1;15
"GCGAAT";4;3;-4;2;10;15
"GCTATA";-7;4;10;15;-7;15
"GCTTAG";-1;0;16;6;-6;15
"GGACGG";0;-7;3;8;11;15
"GGAGTA";2;3;3;6;1;15
"GGCGTC";8;-4;-1;14;-2;15
"GTAAAT";-1;3;-2;10;5;15
"GTCATA";-7;9;4;15;-6;15
"GTGACG";-1;8;3;5;0;15
"GTGAGT";1;7;-6;6;7;15
"GTTTGG";-4;4;14;10;-9;15
"TAAACT";4;4;1;-4;10;15
"TAAAGA";5;7;2;-4;5;15
"TACAAT";5;2;1;-4;11;15
"TATGAG";2;1;13;-3;2;15
"TCACCG";-2;2;4;2;9;15
"TCACGT";0;1;-5;3;16;15
"TCAGAC";13;2;-5;3;2;15
"TCCCAG";-1;0;4;2;10;15
"TCCTGC";13;4;-1;2;-3;15
"TCGGGC";15;6;-9;-1;4;15
"TCTAAG";1;2;11;-1;2;15
"TGAGAG";10;1;4;-10;10;15
"TGCTGG";10;3;8;-11;5;15
"TGGGGG";12;5;0;-14;12;15
"TTAGGC";10;6;-7;7;-1;15
"TTCCGG";-4;4;2;6;7;15
"TTCGTA";-2;14;2;4;-3;15
"TTTAGG";-2;6;9;3;-1;15
"AAAAGC";9;-2;3;7;-1;16
"AAATCG";2;4;18;-5;-3;16
"AAATGT";4;3;9;-4;4;16
"AACATA";-3;6;12;4;-3;16
"AACTAG";3;2;18;-5;-2;16
"AAGGAG";5;4;10;-8;5;16
"AATGTT";-5;1;14;6;0;16
"ACCCTT";-8;0;5;11;8;16
"ACGAAG";4;5;8;-6;5;16
"ACTATT";-6;2;12;8;0;16
"ACTCCA";-6;-1;7;12;4;16
"AGAGTT";3;1;5;-1;8;16
"AGTGAA";6;-2;7;0;5;16
"ATAAAG";-1;5;10;2;0;16
"ATCGTC";2;5;3;15;-9;16
"ATGAGG";1;9;6;-2;2;16
"CACATC";5;1;5;10;-5;16
"CACTTT";0;6;11;-1;0;16
"CAGGTT";2;8;3;-4;7;16
"CATTCA";2;5;13;0;-4;16
"CCGATT";1;9;1;-2;7;16
"CCGCCA";1;6;-4;2;11;16
"CCTCCC";2;-6;0;18;2;16
"CCTTTG";-4;6;21;2;-9;16
"CGATCA";10;5;4;-7;4;16
"CGCTAA";11;3;4;-7;5;16
"CGGGAA";13;5;-4;-10;12;16
"CGTCCG";-1;-7;9;5;10;16
"CGTCGT";1;-8;0;6;17;16
"CGTGAC";14;-7;0;6;3;16
"CTAATT";-4;9;3;6;2;16
"CTACCA";-4;6;-2;10;6;16
"CTCCAA";-3;4;-2;10;7;16
"CTTAAA";-1;6;5;7;-1;16
"GAAAAA";2;2;4;6;2;16
"GACCGC";3;-8;-3;21;3;16
"GAGACT";3;3;-1;2;9;16
"GAGAGA";4;6;0;2;4;16
"GATAGC";5;-6;4;18;-5;16
"GATTCG";-2;0;19;6;-7;16
"GATTGT";0;-1;10;7;0;16
"GCACAT";-3;-4;-3;13;13;16
"GCATCC";9;1;1;12;-7;16
"GCCTAC";10;-1;1;12;-6;16
"GCGCCG";-3;1;2;8;8;16
"GCGCGT";-1;0;-7;9;15;16
"GCGGAC";12;1;-7;9;1;16
"GGAAGC";13;-6;-5;11;3;16
"GGATCG";6;0;10;-1;1;16
"GGATGT";8;-1;1;0;8;16
"GGCTAG";7;-2;10;-1;2;16
"GGGGAG";9;0;2;-4;9;16
"GGTGTT";-1;-3;6;10;4;16
"GTACCG";-8;1;4;16;3;16
"GTACGT";-6;0;-5;17;10;16
"GTAGAC";7;1;-5;17;-4;16
"GTCCAG";-7;-1;4;16;4;16
"GTCTGC";7;3;-1;16;-9;16
"GTGGGC";9;5;-9;13;-2;16
"GTTAAG";-5;1;11;13;-4;16
"TAAGCC";12;2;-2;3;1;16
"TACCCG";-2;0;7;2;9;16
"TACCGT";0;-1;-2;3;16;16
"TACGAC";13;0;-2;3;2;16
"TATACG";0;2;14;-1;1;16
"TATAGT";2;1;5;0;8;16
"TCAACC";11;3;-4;5;1;16
"TCATCT";6;8;2;-6;6;16
"TCATGA";7;11;3;-6;1;16
"TCCAAC";12;1;-4;5;2;16
"TCCTAT";7;6;2;-6;7;16
"TCGGAT";9;8;-6;-9;14;16
"TCTCGG";-4;-1;8;6;7;16
"TCTGTA";-2;9;8;4;-3;16
"TGAACG";8;2;5;-8;9;16
"TGAAGT";10;1;-4;-7;16;16
"TGCAAG";9;0;5;-8;10;16
"TTAGAT";4;8;-4;-1;9;16
"TTCAGC";9;5;-6;9;-1;16
"TTCTGT";4;10;0;-2;4;16
"TTGGCG";4;13;1;-6;4;16
"TTGGGT";6;12;-8;-5;11;16
"AAAAAT";3;0;6;-1;9;17
"AAGACG";3;5;11;-6;4;17
"AAGAGT";5;4;2;-5;11;17
"AATTGG";0;1;22;-1;-5;17
"ACACAG";-3;-2;9;5;8;17
"ACATGC";11;2;4;5;-5;17
"ACCTTA";-1;10;13;2;-7;17
"ACGCGG";-1;2;5;1;10;17
"ACGGTA";1;12;5;-1;0;17
"ACTGTC";2;0;9;15;-9;17
"AGATGG";8;1;13;-8;3;17
"AGCATT";2;0;6;1;8;17
"AGCCCA";2;-3;1;5;12;17
"AGTACA";4;-1;8;2;4;17
"AGTGTG";-1;-1;18;2;-1;17
"ATACGG";-6;2;7;9;5;17
"ATAGTA";-4;12;7;7;-5;17
"CAAATA";-1;8;9;2;-1;17
"CAATAG";5;4;15;-7;0;17
"CAGTGG";7;8;11;-11;2;17
"CCACTT";-6;2;2;9;10;17
"CCCTTC";7;5;6;8;-9;17
"CCGGTC";9;7;-2;5;-2;17
"CCTCAA";-3;-1;4;10;7;17
"CGCCCC";10;-8;-6;11;10;17
"CGCTTG";4;4;15;-5;-1;17
"CGGACA";11;6;-3;-8;11;17
"CGGGTG";6;6;7;-8;6;17
"CGTACC";12;-6;1;8;2;17
"CGTTGA";8;2;8;-3;2;17
"CTAGTC";4;7;0;13;-7;17
"CTCCTG";-10;5;9;12;1;17
"CTTATG";-8;7;16;9;-7;17
"CTTCCT";-7;0;1;14;9;17
"CTTCGA";-6;3;2;14;4;17
"GAAATG";-5;3;15;8;-4;17
"GAACCT";-4;-4;0;13;12;17
"GAACGA";-3;-1;1;13;7;17
"GACCAT";-3;-6;0;13;13;17
"GACTCC";9;-1;4;12;-7;17
"GAGGCC";11;1;-4;9;0;17
"GATAAT";-1;-4;7;10;5;17
"GCATAA";4;6;5;4;-2;17
"GCGACC";10;2;-6;11;0;17
"GCGTCT";5;7;0;0;5;17
"GCGTGA";6;10;1;0;0;17
"GCTCAG";-7;-6;10;16;4;17
"GCTTGC";7;-2;5;16;-9;17
"GGAAAT";7;-4;-2;3;13;17
"GGCATA";1;2;4;8;2;17
"GGGACG";7;1;3;-2;8;17
"GGGAGT";9;0;-6;-1;15;17
"GGTTGG";4;-3;14;3;-1;17
"GTAACC";5;2;-4;19;-5;17
"GTATCT";0;7;2;8;0;17
"GTATGA";1;10;3;8;-5;17
"GTCAAC";6;0;-4;19;-4;17
"GTCTAT";1;5;2;8;1;17
"GTGGAT";3;7;-6;5;8;17
"GTTCGG";-10;-2;8;20;1;17
"GTTGTA";-8;8;8;18;-9;17
"TAAGAA";7;7;2;-5;6;17
"TACACC";11;1;-1;5;1;17
"TACTGA";7;9;6;-6;1;17
"TAGGCT";8;8;-3;-9;13;17
"TAGGGA";9;11;-2;-9;8;17
"TATGGC";10;-1;2;7;-1;17
"TCAAAA";6;8;0;-3;6;17
"TCCCGC";7;-2;-7;12;7;17
"TCGACT";7;9;-5;-7;13;17
"TCGAGA";8;12;-4;-7;8;17
"TCTAGC";9;0;0;9;-1;17
"TCTTCG";2;6;15;-3;-3;17
"TCTTGT";4;5;6;-2;4;17
"TGAGGC";18;-1;-7;0;7;17
"TGCCGG";4;-3;2;-1;15;17
"TGCGTA";6;7;2;-3;5;17
"TGTAGG";6;-1;9;-4;7;17
"TTAACT";2;9;-3;1;8;17
"TTAAGA";3;12;-2;1;3;17
"TTCAAT";3;7;-3;1;9;17
"TTTGAG";0;6;9;2;0;17
"AAACCG";-4;-2;12;5;7;18
"AAACGT";-2;-3;3;6;14;18
"AAAGAC";11;-2;3;6;0;18
"AACCAG";-3;-4;12;5;8;18
"AACTGC";11;0;7;5;-5;18
"AAGGGC";13;2;-1;2;2;18
"AATAAG";-1;-2;19;2;0;18
"ACAAAC";10;-1;1;8;0;18
"ACATAT";5;4;7;-3;5;18
"ACGAGC";12;3;-3;4;2;18
"ACGTCG";5;9;12;-8;0;18
"ACGTGT";7;8;3;-7;7;18
"AGAAAG";7;-2;10;-5;8;18
"AGCGTC";10;-2;3;8;-1;18
"AGGAGG";9;2;6;-9;10;18
"ATAAGC";7;3;-1;12;-3;18
"ATATCG";0;9;14;0;-5;18
"ATATGT";2;8;5;1;2;18
"ATCATA";-5;11;8;9;-5;18
"ATCTAG";1;7;14;0;-4;18
"ATGGAG";3;9;6;-3;3;18
"ATTGTT";-7;6;10;11;-2;18
"CACCTT";-6;0;5;9;10;18
"CAGAAG";6;5;8;-8;7;18
"CATATT";-4;2;12;6;2;18
"CATCCA";-4;-1;7;10;6;18
"CCATTA";1;12;10;0;-5;18
"CCTCTG";-10;0;15;12;1;18
"CGAATT";4;2;3;-1;10;18
"CGACCA";4;-1;-2;3;14;18
"CGATCT";9;1;2;-3;9;18
"CGCCAA";5;-3;-2;3;15;18
"CGTAAA";7;-1;5;0;7;18
"CTCATC";3;6;1;15;-7;18
"CTCTTT";-2;11;7;4;-2;18
"CTGGTT";0;13;-1;1;5;18
"CTTTCA";0;10;9;5;-6;18
"GAATCA";3;6;8;4;-3;18
"GACTAA";4;4;8;4;-2;18
"GAGGAA";6;6;0;1;5;18
"GATCCG";-8;-6;13;16;3;18
"GATCGT";-6;-7;4;17;10;18
"GATGAC";7;-6;4;17;-4;18
"GCACCC";3;-5;-5;22;3;18
"GCATTG";-3;7;16;6;-8;18
"GCCCAC";4;-7;-5;22;4;18
"GCGAAA";5;7;-2;3;5;18
"GCTAAC";6;-5;2;19;-4;18
"GCTTAT";1;0;8;8;1;18
"GGACCG";0;-6;4;9;11;18
"GGACGT";2;-7;-5;10;18;18
"GGAGAC";15;-6;-5;10;4;18
"GGCCAG";1;-8;4;9;12;18
"GGCTGC";15;-4;-1;9;-1;18
"GGGGGC";17;-2;-9;6;6;18
"GGTAAG";3;-6;11;6;4;18
"GTAAAA";0;7;0;11;0;18
"GTCCGC";1;-3;-7;26;1;18
"GTGACT";1;8;-5;7;7;18
"GTGAGA";2;11;-4;7;2;18
"GTTAGC";3;-1;0;23;-7;18
"GTTTCG";-4;5;15;11;-9;18
"GTTTGT";-2;4;6;12;-2;18
"TAAACA";5;8;3;-3;5;18
"TAAGTG";0;8;13;-3;0;18
"TACAAA";6;6;3;-3;6;18
"TATGAT";4;1;5;-1;9;18
"TCAATG";-1;9;11;-1;0;18
"TCACCT";0;2;-4;4;16;18
"TCACGA";1;5;-3;4;11;18
"TCCCAT";1;0;-4;4;17;18
"TCCTCC";13;5;0;3;-3;18
"TCGGCC";15;7;-8;0;4;18
"TCTAAT";3;2;3;1;9;18
"TGAGAT";12;1;-4;-8;17;18
"TGCAGC";17;-2;-6;2;7;18
"TGCTGT";12;3;0;-9;12;18
"TGGGCG";12;6;1;-13;12;18
"TGGGGT";14;5;-8;-12;19;18
"TTAGCC";10;7;-6;8;-1;18
"TTCCCG";-4;5;3;7;7;18
"TTCCGT";-2;4;-6;8;14;18
"TTCGAC";11;5;-6;8;0;18
"TTTACG";-2;7;10;4;-1;18
"TTTAGT";0;6;1;5;6;18
"AAAACC";9;-1;4;8;-1;19
"AAATCT";4;4;10;-3;4;19
"AAATGA";5;7;11;-3;-1;19
"AACAAC";10;-3;4;8;0;19
"AACTAT";5;2;10;-3;5;19
"AAGGAT";7;4;2;-6;12;19
"AATCGG";-6;-5;16;9;5;19
"AATGTA";-4;5;16;7;-5;19
"ACACGC";5;-4;-2;15;5;19
"ACCCTA";-7;4;7;12;3;19
"ACGAAT";6;5;0;-4;12;19
"ACTATA";-5;6;14;9;-5;19
"ACTTAG";1;2;20;0;-4;19
"AGACGG";2;-5;7;2;13;19
"AGAGTA";4;5;7;0;3;19
"ATAAAT";1;5;2;4;7;19
"ATGACG";1;10;7;-1;2;19
"ATGAGT";3;9;-2;0;9;19
"ATTTGG";-2;6;18;4;-7;19
"CAACAG";-1;-2;9;3;10;19
"CAATGC";13;2;4;3;-3;19
"CACTTA";1;10;13;0;-5;19
"CAGCGG";1;2;5;-1;12;19
"CAGGTA";3;12;5;-3;2;19
"CATGTC";4;0;9;13;-7;19
"CCCCTC";1;-1;0;18;1;19
"CCGATA";2;13;3;-1;2;19
"CCGTAG";8;9;9;-10;3;19
"CCTATC";3;1;7;15;-7;19
"CCTTTT";-2;6;13;4;-2;19
"CGAGTC";12;0;0;6;1;19
"CGCCTG";-2;-2;9;5;9;19
"CGTATG";0;0;16;2;1;19
"CGTCCT";1;-7;1;7;17;19
"CGTCGA";2;-4;2;7;12;19
"CTAATA";-3;13;5;7;-3;19
"CTATAG";3;9;11;-2;-2;19
"CTGTGG";5;13;7;-6;0;19
"GACCCC";3;-7;-2;22;3;19
"GACTTG";-3;5;19;6;-8;19
"GAGACA";4;7;1;3;4;19
"GAGGTG";-1;7;11;3;-1;19
"GATACC";5;-5;5;19;-5;19
"GATTCT";0;0;11;8;0;19
"GATTGA";1;3;12;8;-5;19
"GCACAA";-2;0;-1;14;8;19
"GCGATG";-2;8;9;5;-1;19
"GCGCCT";-1;1;-6;10;15;19
"GCGCGA";0;4;-5;10;10;19
"GCTCGC";1;-8;-1;26;1;19
"GGAACC";13;-5;-4;12;3;19
"GGATCT";8;0;2;1;8;19
"GGATGA";9;3;3;1;3;19
"GGCAAC";14;-7;-4;12;4;19
"GGCTAT";9;-2;2;1;9;19
"GGGGAT";11;0;-6;-2;16;19
"GGTCGG";-2;-9;8;13;9;19
"GGTGTA";0;1;8;11;-1;19
"GTAATG";-7;8;11;13;-6;19
"GTACCT";-6;1;-4;18;10;19
"GTACGA";-5;4;-3;18;5;19
"GTCCAT";-5;-1;-4;18;11;19
"GTCTCC";7;4;0;17;-9;19
"GTGGCC";9;6;-8;14;-2;19
"GTTAAT";-3;1;3;15;3;19
"TACATG";-1;7;14;-1;0;19
"TACCCT";0;0;-1;4;16;19
"TACCGA";1;3;0;4;11;19
"TATACT";2;2;6;1;8;19
"TATAGA";3;5;7;1;3;19
"TCATCA";7;12;4;-5;1;19
"TCCTAA";8;10;4;-5;2;19
"TCGGAA";10;12;-4;-8;9;19
"TCTCCG";-4;0;9;7;7;19
"TCTCGT";-2;-1;0;8;14;19
"TCTGAC";11;0;0;8;0;19
"TGAACT";10;2;-3;-6;16;19
"TGAAGA";11;5;-2;-6;11;19
"TGCAAT";11;0;-3;-6;17;19
"TGTGAG";8;-1;9;-5;8;19
"TTAGAA";5;12;-2;0;4;19
"TTCACC";9;6;-5;10;-1;19
"TTCTGA";5;14;2;-1;-1;19
"TTGGCT";6;13;-7;-4;11;19
"TTGGGA";7;16;-6;-4;6;19
"TTTGGC";8;4;-2;12;-3;19
"AAAAAA";4;4;8;0;4;20
"AACCGC";5;-6;1;15;5;20
"AAGACT";5;5;3;-4;11;20
"AAGAGA";6;8;4;-4;6;20
"AATAGC";7;-4;8;12;-3;20
"AATTCG";0;2;23;0;-5;20
"AATTGT";2;1;14;1;2;20
"ACACAT";-1;-2;1;7;15;20
"ACATCC";11;3;5;6;-5;20
"ACCTAC";12;1;5;6;-4;20
"ACGCCG";-1;3;6;2;10;20
"ACGCGT";1;2;-3;3;17;20
"ACGGAC";14;3;-3;3;3;20
"AGAAGC";15;-4;-1;5;5;20
"AGATCG";8;2;14;-7;3;20
"AGATGT";10;1;5;-6;10;20
"AGCATA";3;4;8;2;3;20
"AGCTAG";9;0;14;-7;4;20
"AGGGAG";11;2;6;-10;11;20
"AGTGTT";1;-1;10;4;6;20
"ATACCG";-6;3;8;10;5;20
"ATACGT";-4;2;-1;11;12;20
"ATAGAC";9;3;-1;11;-2;20
"ATCCAG";-5;1;8;10;6;20
"ATCTGC";9;5;3;10;-7;20
"ATGGGC";11;7;-5;7;0;20
"ATTAAG";-3;3;15;7;-2;20
"CAAAAC";12;-1;1;6;2;20
"CAATAT";7;4;7;-5;7;20
"CAGAGC";14;3;-3;2;4;20
"CAGTCG";7;9;12;-10;2;20
"CAGTGT";9;8;3;-9;9;20
"CCACTA";-5;6;4;10;5;20
"CGCATC";11;-1;1;8;1;20
"CGCTTT";6;4;7;-3;6;20
"CGGGTT";8;6;-1;-6;13;20
"CGTTCA";8;3;9;-2;2;20
"CTCCTT";-8;5;1;14;8;20
"CTGAAG";4;10;4;-3;5;20
"CTTATT";-6;7;8;11;0;20
"CTTCCA";-6;4;3;15;4;20
"GAAATT";-3;3;7;10;3;20
"GAACCA";-3;0;2;14;7;20
"GACCAA";-2;-2;2;14;8;20
"GATAAA";0;0;9;11;0;20
"GCACTG";-9;1;10;16;2;20
"GCGTCA";6;11;2;1;0;20
"GCTCAT";-5;-6;2;18;11;20
"GCTTCC";7;-1;6;17;-9;20
"GGAAAA";8;0;0;4;8;20
"GGCCGC";9;-10;-7;19;9;20
"GGGACT";9;1;-5;0;15;20
"GGGAGA";10;4;-4;0;10;20
"GGTAGC";11;-8;0;16;1;20
"GGTTCG";4;-2;15;4;-1;20
"GGTTGT";6;-3;6;5;6;20
"GTATCA";1;11;4;9;-5;20
"GTCTAA";2;9;4;9;-4;20
"GTGGAA";4;11;-4;6;3;20
"GTTCCG";-10;-1;9;21;1;20
"GTTCGT";-8;-2;0;22;8;20
"GTTGAC";5;-1;0;22;-6;20
"TAGGCA";9;12;-1;-8;8;20
"TATGCC";10;0;3;8;-1;20
"TCCCCC";7;-1;-6;13;7;20
"TCCTTG";1;11;15;-3;-4;20
"TCGACA";8;13;-3;-6;8;20
"TCGGTG";3;13;7;-6;3;20
"TCTACC";9;1;1;10;-1;20
"TCTTCT";4;6;7;-1;4;20
"TCTTGA";5;9;8;-1;-1;20
"TGAGCC";18;0;-6;1;7;20
"TGCCCG";4;-2;3;0;15;20
"TGCCGT";6;-3;-6;1;22;20
"TGCGAC";19;-2;-6;1;8;20
"TGTACG";6;0;10;-3;7;20
"TGTAGT";8;-1;1;-2;14;20
"TTAACA";3;13;-1;2;3;20
"TTAGTG";-2;13;9;2;-2;20
"TTCAAA";4;11;-1;2;4;20
"TTTGAT";2;6;1;4;7;20
"AAAATG";-3;5;19;2;-2;21
"AAACCT";-2;-2;4;7;14;21
"AAACGA";-1;1;5;7;9;21
"AACCAT";-1;-4;4;7;15;21
"AACTCC";11;1;8;6;-5;21
"AAGGCC";13;3;0;3;2;21
"AATAAT";1;-2;11;4;7;21
"ACATAA";6;8;9;-2;0;21
"ACGACC";12;4;-2;5;2;21
"ACGTCT";7;9;4;-6;7;21
"ACGTGA";8;12;5;-6;2;21
"ACTCAG";-5;-4;14;10;6;21
"ACTTGC";9;0;9;10;-7;21
"AGAAAT";9;-2;2;-3;15;21
"AGGACG";9;3;7;-8;10;21
"AGGAGT";11;2;-2;-7;17;21
"AGTTGG";6;-1;18;-3;1;21
"ATAACC";7;4;0;13;-3;21
"ATATCT";2;9;6;2;2;21
"ATATGA";3;12;7;2;-3;21
"ATCAAC";8;2;0;13;-2;21
"ATCTAT";3;7;6;2;3;21
"ATGGAT";5;9;-2;-1;10;21
"ATTCGG";-8;0;12;14;3;21
"ATTGTA";-6;10;12;12;-7;21
"CAACGC";7;-4;-2;13;7;21
"CACCTA";-5;4;7;10;5;21
"CAGAAT";8;5;0;-6;14;21
"CATATA";-3;6;14;7;-3;21
"CATTAG";3;2;20;-2;-2;21
"CCATAC";14;3;2;4;-2;21
"CCGCAG";2;3;3;0;13;21
"CCGTGC";16;7;-2;0;0;21
"CCTCTT";-8;0;7;14;8;21
"CGAATA";5;6;5;0;5;21
"CGATAG";11;2;11;-9;6;21
"CGGTGG";13;6;7;-13;8;21
"CTACAG";-3;3;5;8;8;21
"CTATGC";11;7;0;8;-5;21
"CTCTTA";-1;15;9;5;-7;21
"CTGCGG";-1;7;1;4;10;21
"CTGGTA";1;17;1;2;0;21
"CTTGTC";2;5;5;18;-9;21
"GAAGTC";5;1;4;17;-6;21
"GACCTG";-9;-1;13;16;2;21
"GATATG";-7;1;20;13;-6;21
"GATCCT";-6;-6;5;18;10;21
"GATCGA";-5;-3;6;18;5;21
"GCAATC";4;2;2;19;-6;21
"GCATTT";-1;7;8;8;-1;21
"GCTTAA";2;4;10;9;-4;21
"GGAATG";1;1;11;6;2;21
"GGACCT";2;-6;-4;11;18;21
"GGACGA";3;-3;-3;11;13;21
"GGCCAT";3;-8;-4;11;19;21
"GGCTCC";15;-3;0;10;-1;21
"GGGGCC";17;-1;-8;7;6;21
"GGTAAT";5;-6;3;8;11;21
"GTCCCC";1;-2;-6;27;1;21
"GTCTTG";-5;10;15;11;-10;21
"GTGACA";2;12;-3;8;2;21
"GTGGTG";-3;12;7;8;-3;21
"GTTACC";3;0;1;24;-7;21
"GTTTCT";-2;5;7;13;-2;21
"GTTTGA";-1;8;8;13;-7;21
"TAAGTT";2;8;5;-1;7;21
"TATGAA";5;5;7;0;4;21
"TCAATT";1;9;3;1;7;21
"TCACCA";1;6;-2;5;11;21
"TCCCAA";2;4;-2;5;12;21
"TCTAAA";4;6;5;2;4;21
"TGAGAA";13;5;-2;-7;12;21
"TGCACC";17;-1;-5;3;7;21
"TGCTGA";13;7;2;-8;7;21
"TGGGCT";14;6;-7;-11;19;21
"TGGGGA";15;9;-6;-11;14;21
"TGTGGC";16;-3;-2;5;5;21
"TTCATG";-3;12;10;4;-2;21
"TTCCCT";-2;5;-5;9;14;21
"TTCCGA";-1;8;-4;9;9;21
"TTTACT";0;7;2;6;6;21
"TTTAGA";1;10;3;6;1;21
"AAATCA";5;8;12;-2;-1;22
"AACTAA";6;6;12;-2;0;22
"AAGGAA";8;8;4;-5;7;22
"AATCCG";-6;-4;17;10;5;22
"AATCGT";-4;-5;8;11;12;22
"AATGAC";9;-4;8;11;-2;22
"ACACCC";5;-3;-1;16;5;22
"ACATTG";-1;9;20;0;-6;22
"ACCCAC";6;-5;-1;16;6;22
"ACGAAA";7;9;2;-3;7;22
"ACTAAC";8;-3;6;13;-2;22
"ACTTAT";3;2;12;2;3;22
"AGACCG";2;-4;8;3;13;22
"AGACGT";4;-5;-1;4;20;22
"AGAGAC";17;-4;-1;4;6;22
"AGCCAG";3;-6;8;3;14;22
"AGCTGC";17;-2;3;3;1;22
"AGGGGC";19;0;-5;0;8;22
"AGTAAG";5;-4;15;0;6;22
"ATAAAA";2;9;4;5;2;22
"ATCCGC";3;-1;-3;20;3;22
"ATGACT";3;10;-1;1;9;22
"ATGAGA";4;13;0;1;4;22
"ATTAGC";5;1;4;17;-5;22
"ATTTCG";-2;7;19;5;-7;22
"ATTTGT";0;6;10;6;0;22
"CAACAT";1;-2;1;5;17;22
"CAATCC";13;3;5;4;-3;22
"CACTAC";14;1;5;4;-2;22
"CAGCCG";1;3;6;0;12;22
"CAGCGT";3;2;-3;1;19;22
"CAGGAC";16;3;-3;1;5;22
"CCGAAC";15;4;-5;3;5;22
"CCGTAT";10;9;1;-8;10;22
"CCTTTA";-1;10;15;5;-7;22
"CGCCTT";0;-2;1;7;16;22
"CGGAAG";12;3;4;-10;13;22
"CGTATT";2;0;8;4;8;22
"CGTCCA";2;-3;3;8;12;22
"CGTTCT";7;-1;7;2;7;22
"CTAAAC";10;4;-3;11;0;22
"CTATAT";5;9;3;0;5;22
"CTGAGC";12;8;-7;7;2;22
"CTGTCG";5;14;8;-5;0;22
"CTGTGT";7;13;-1;-4;7;22
"GACTTT";-1;5;11;8;-1;22
"GAGGTT";1;7;3;5;6;22
"GATTCA";1;4;13;9;-5;22
"GCGATT";0;8;1;7;6;22
"GCGCCA";0;5;-4;11;10;22
"GCTCCC";1;-7;0;27;1;22
"GCTTTG";-5;5;21;11;-10;22
"GGATCA";9;4;4;2;3;22
"GGCTAA";10;2;4;2;4;22
"GGGGAA";12;4;-4;-1;11;22
"GGTCCG";-2;-8;9;14;9;22
"GGTCGT";0;-9;0;15;16;22
"GGTGAC";13;-8;0;15;2;22
"GTAATT";-5;8;3;15;1;22
"GTACCA";-5;5;-2;19;5;22
"GTCCAA";-4;3;-2;19;6;22
"GTTAAA";-2;5;5;16;-2;22
"TAATGG";7;8;13;-8;2;22
"TACATT";1;7;6;1;7;22
"TACCCA";1;4;1;5;11;22
"TACTCG";4;6;13;0;-1;22
"TATACA";3;6;8;2;3;22
"TATGTG";-2;6;18;2;-2;22
"TCAGTC";9;7;0;8;-2;22
"TCCCTG";-5;5;9;7;6;22
"TCTATG";-3;7;16;4;-2;22
"TCTCCT";-2;0;1;9;14;22
"TCTCGA";-1;3;2;9;9;22
"TGAACA";11;6;-1;-5;11;22
"TGAGTG";6;6;9;-5;6;22
"TGCAAA";12;4;-1;-5;12;22
"TGTGAT";10;-1;1;-3;15;22
"TTGGCA";7;17;-5;-3;6;22
"TTTGCC";8;5;-1;13;-3;22
"AACCCC";5;-5;2;16;5;23
"AACTTG";-1;7;23;0;-6;23
"AAGACA";6;9;5;-3;6;23
"AAGGTG";1;9;15;-3;1;23
"AATACC";7;-3;9;13;-3;23
"AATTCT";2;2;15;2;2;23
"AATTGA";3;5;16;2;-3;23
"ACACAA";0;2;3;8;10;23
"ACGATG";0;10;13;-1;1;23
"ACGCCT";1;3;-2;4;17;23
"ACGCGA";2;6;-1;4;12;23
"ACTCGC";3;-6;3;20;3;23
"AGAACC";15;-3;0;6;5;23
"AGATGA";11;5;7;-5;5;23
"AGCAAC";16;-5;0;6;6;23
"AGCTAT";11;0;6;-5;11;23
"AGGGAT";13;2;-2;-8;18;23
"AGTCGG";0;-7;12;7;11;23
"AGTGTA";2;3;12;5;1;23
"ATAATG";-5;10;15;7;-4;23
"ATACCT";-4;3;0;12;12;23
"ATACGA";-3;6;1;12;7;23
"ATCCAT";-3;1;0;12;13;23
"ATCTCC";9;6;4;11;-7;23
"ATGGCC";11;8;-4;8;0;23
"ATTAAT";-1;3;7;9;5;23
"CAATAA";8;8;9;-4;2;23
"CAGACC";14;4;-2;3;4;23
"CAGTCT";9;9;4;-8;9;23
"CAGTGA";10;12;5;-8;4;23
"CATCAG";-3;-4;14;8;8;23
"CATTGC";11;0;9;8;-5;23
"CCACAC";8;-3;-4;14;8;23
"CCGCGC";10;1;-8;10;10;23
"CGACAG";5;-4;5;1;16;23
"CGATGC";19;0;0;1;3;23
"CGCTTA";7;8;9;-2;1;23
"CGGCGG";7;0;1;-3;18;23
"CGGGTA";9;10;1;-5;8;23
"CGTGTC";10;-2;5;11;-1;23
"CTACGC";5;1;-6;18;5;23
"CTCCTA";-7;9;3;15;3;23
"CTGAAT";6;10;-4;-1;12;23
"CTTATA";-5;11;10;12;-5;23
"CTTTAG";1;7;16;3;-4;23
"GAAATA";-2;7;9;11;-2;23
"GAATAG";4;3;15;2;-1;23
"GAGTGG";6;7;11;-2;1;23
"GCACTT";-7;1;2;18;9;23
"GCCTTC";6;4;6;17;-10;23
"GCGGTC";8;6;-2;14;-3;23
"GCTCAA";-4;-2;4;19;6;23
"GGCCCC";9;-9;-6;20;9;23
"GGCTTG";3;3;15;4;-2;23
"GGGACA";10;5;-3;1;10;23
"GGGGTG";5;5;7;1;5;23
"GGTACC";11;-7;1;17;1;23
"GGTTCT";6;-2;7;6;6;23
"GGTTGA";7;1;8;6;1;23
"GTAGTC";3;6;0;22;-8;23
"GTCCTG";-11;4;9;21;0;23
"GTTATG";-9;6;16;18;-8;23
"GTTCCT";-8;-1;1;23;8;23
"GTTCGA";-7;2;2;23;3;23
"TAAAAG";6;5;10;-5;7;23
"TACGTC";9;5;3;8;-2;23
"TACTCT";6;6;5;0;6;23
"TAGAGG";8;9;6;-9;9;23
"TCCATC";8;6;1;10;-2;23
"TCCTTT";3;11;7;-1;3;23
"TCGGTT";5;13;-1;-4;10;23
"TCTTCA";5;10;9;0;-1;23
"TGCATG";5;5;10;-3;6;23
"TGCCCT";6;-2;-5;2;22;23
"TGCCGA";7;1;-4;2;17;23
"TGTACT";8;0;2;-1;14;23
"TGTAGA";9;3;3;-1;9;23
"TTAGTT";0;13;1;4;5;23
"TTTGAA";3;10;3;5;2;23
"AAAATT";-1;5;11;4;5;24
"AAACCA";-1;2;6;8;9;24
"AACCAA";0;0;6;8;10;24
"AATAAA";2;2;13;5;2;24
"ACACTG";-7;3;14;10;4;24
"ACGTCA";8;13;6;-5;2;24
"ACTCAT";-3;-4;6;12;13;24
"ACTTCC";9;1;10;11;-7;24
"AGAAAA";10;2;4;-2;10;24
"AGCCGC";11;-8;-3;13;11;24
"AGGACT";11;3;-1;-6;17;24
"AGGAGA";12;6;0;-6;12;24
"AGTAGC";13;-6;4;10;3;24
"AGTTCG";6;0;19;-2;1;24
"AGTTGT";8;-1;10;-1;8;24
"ATATCA";3;13;8;3;-3;24
"ATCTAA";4;11;8;3;-2;24
"ATGGAA";6;13;0;0;5;24
"ATTCCG";-8;1;13;15;3;24
"ATTCGT";-6;0;4;16;10;24
"ATTGAC";7;1;4;16;-4;24
"CAACCC";7;-3;-1;14;7;24
"CAATTG";1;9;20;-2;-4;24
"CACCAC";8;-5;-1;14;8;24
"CAGAAA";9;9;2;-5;9;24
"CATAAC";10;-3;6;11;0;24
"CATTAT";5;2;12;0;5;24
"CCGCAT";4;3;-5;2;20;24
"CCGTCC";16;8;-1;1;0;24
"CCTCTA";-7;4;9;15;3;24
"CGAAAC";18;-3;-3;4;8;24
"CGATAT";13;2;3;-7;13;24
"CGGAGC";20;1;-7;0;10;24
"CGGTCG";13;7;8;-12;8;24
"CGGTGT";15;6;-1;-11;15;24
"CTACAT";-1;3;-3;10;15;24
"CTATCC";11;8;1;9;-5;24
"CTCTAC";12;6;1;9;-4;24
"CTGCCG";-1;8;2;5;10;24
"CTGCGT";1;7;-7;6;17;24
"CTGGAC";14;8;-7;6;3;24
"GACATC";4;0;5;19;-4;24
"GACCTT";-7;-1;5;18;9;24
"GAGAAG";5;4;8;1;6;24
"GATATT";-5;1;12;15;1;24
"GATCCA";-5;-2;7;19;5;24
"GCATTA";0;11;10;9;-6;24
"GCTCTG";-11;-1;15;21;0;24
"GGAATT";3;1;3;8;9;24
"GGACCA";3;-2;-2;12;13;24
"GGCCAA";4;-4;-2;12;14;24
"GGTAAA";6;-2;5;9;6;24
"GTCTTT";-3;10;7;13;-3;24
"GTGGTT";-1;12;-1;10;4;24
"GTTTCA";-1;9;9;14;-7;24
"TAACGG";1;2;7;2;12;24
"TAAGTA";3;12;7;0;2;24
"TCAATA";2;13;5;2;2;24
"TCATAG";8;9;11;-7;3;24
"TCGTGG";10;13;7;-11;5;24
"TGGGCA";15;10;-5;-10;14;24
"TGTGCC";16;-2;-1;6;5;24
"TTATGG";5;13;9;-3;0;24
"TTCATT";-1;12;2;6;5;24
"TTCCCA";-1;9;-3;10;9;24
"TTCTCG";2;11;9;5;-3;24
"TTTACA";1;11;4;7;1;24
"TTTGTG";-4;11;14;7;-4;24
"AAAGTC";7;3;8;11;-4;25
"AACCTG";-7;1;17;10;4;25
"AATATG";-5;3;24;7;-4;25
"AATCCT";-4;-4;9;12;12;25
"AATCGA";-3;-1;10;12;7;25
"ACAATC";6;4;6;13;-4;25
"ACATTT";1;9;12;2;1;25
"ACTTAA";4;6;14;3;-2;25
"AGAATG";3;3;15;0;4;25
"AGACCT";4;-4;0;5;20;25
"AGACGA";5;-1;1;5;15;25
"AGATCT";10;2;6;-3;10;25
"AGCCAT";5;-6;0;5;21;25
"AGCTCC";17;-1;4;4;1;25
"AGGGCC";19;1;-4;1;8;25
"AGTAAT";7;-4;7;2;13;25
"ATCCCC";3;0;-2;21;3;25
"ATCTTG";-3;12;19;5;-8;25
"ATGACA";4;14;1;2;4;25
"ATGGTG";-1;14;11;2;-1;25
"ATTACC";5;2;5;18;-5;25
"ATTTCT";0;7;11;7;0;25
"ATTTGA";1;10;12;7;-5;25
"CAACAA";2;2;3;6;12;25
"CAGATG";2;10;13;-3;3;25
"CAGCCT";3;3;-2;2;19;25
"CAGCGA";4;6;-1;2;14;25
"CATCGC";5;-6;3;18;5;25
"CCGTAA";11;13;3;-7;5;25
"CCTTAC";12;1;7;9;-4;25
"CGACGC";13;-6;-6;11;13;25
"CGCCTA";1;2;3;8;11;25
"CGGAAT";14;3;-4;-8;20;25
"CGTATA";3;4;10;5;3;25
"CGTTAG";9;0;16;-4;4;25
"CTATAA";6;13;5;1;0;25
"CTGACC";12;9;-6;8;2;25
"CTGTCT";7;14;0;-3;7;25
"CTGTGA";8;17;1;-3;2;25
"CTTCAG";-5;1;10;13;6;25
"CTTTGC";9;5;5;13;-7;25
"GAACAG";-2;-3;9;12;9;25
"GAATGC";12;1;4;12;-4;25
"GACTTA";0;9;13;9;-6;25
"GAGCGG";0;1;5;8;11;25
"GAGGTA";2;11;5;6;1;25
"GATGTC";3;-1;9;22;-8;25
"GCCCTC";0;-2;0;27;0;25
"GCGATA";1;12;3;8;1;25
"GCGTAG";7;8;9;-1;2;25
"GCTATC";2;0;7;24;-8;25
"GCTTTT";-3;5;13;13;-3;25
"GGAGTC";11;-1;0;15;0;25
"GGCCTG";-3;-3;9;14;8;25
"GGTATG";-1;-1;16;11;0;25
"GGTCCT";0;-8;1;16;16;25
"GGTCGA";1;-5;2;16;11;25
"GTAATA";-4;12;5;16;-4;25
"GTATAG";2;8;11;7;-3;25
"GTGTGG";4;12;7;3;-1;25
"TAAAGC";14;3;-1;5;4;25
"TAATCG";7;9;14;-7;2;25
"TAATGT";9;8;5;-6;9;25
"TACATA";2;11;8;2;2;25
"TACTAG";8;7;14;-7;3;25
"TACTCA";7;10;7;0;1;25
"TAGGAG";10;9;6;-10;10;25
"TATGTT";0;6;10;4;5;25
"TCCCTT";-3;5;1;9;13;25
"TCGAAG";9;10;4;-8;10;25
"TCTATT";-1;7;8;6;5;25
"TCTCCA";-1;4;3;10;9;25
"TGAGTT";8;6;1;-3;13;25
"TGTGAA";11;3;3;-2;10;25
"TTAAAG";4;10;6;0;5;25
"TTCGTC";7;10;-1;13;-4;25
"TTCTCT";4;11;1;5;4;25
"TTGAGG";6;14;2;-4;7;25
"AACATC";6;2;9;13;-4;26
"AACTTT";1;7;15;2;1;26
"AAGGTT";3;9;7;-1;8;26
"AATTCA";3;6;17;3;-3;26
"ACGATT";2;10;5;1;8;26
"ACGCCA";2;7;0;5;12;26
"ACTCCC";3;-5;4;21;3;26
"ACTTTG";-3;7;25;5;-8;26
"AGATCA";11;6;8;-4;5;26
"AGCTAA";12;4;8;-4;6;26
"AGGGAA";14;6;0;-7;13;26
"AGTCCG";0;-6;13;8;11;26
"AGTCGT";2;-7;4;9;18;26
"AGTGAC";15;-6;4;9;4;26
"ATAATT";-3;10;7;9;3;26
"ATACCA";-3;7;2;13;7;26
"ATCCAA";-2;5;2;13;8;26
"ATTAAA";0;7;9;10;0;26
"CAACTG";-5;3;14;8;6;26
"CAGTCA";10;13;6;-7;4;26
"CATCAT";-1;-4;6;10;15;26
"CATTCC";11;1;10;9;-5;26
"CCGCCC";10;2;-7;11;10;26
"CCGTTG";4;14;14;-5;-1;26
"CGACAT";7;-4;-3;3;23;26
"CGATCC";19;1;1;2;3;26
"CGCTAC";20;-1;1;2;4;26
"CGGCCG";7;1;2;-2;18;26
"CGGCGT";9;0;-7;-1;25;26
"CGGGAC";22;1;-7;-1;11;26
"CTACCC";5;2;-5;19;5;26
"CTATTG";-1;14;16;3;-6;26
"CTCCAC";6;0;-5;19;6;26
"CTGAAA";7;14;-2;0;7;26
"CTTAAC";8;2;2;16;-2;26
"CTTTAT";3;7;8;5;3;26
"GAAAAC";11;-2;1;15;1;26
"GAATAT";6;3;7;4;6;26
"GAGAGC";13;2;-3;11;3;26
"GAGTCG";6;8;12;-1;1;26
"GAGTGT";8;7;3;0;8;26
"GCACTA";-6;5;4;19;4;26
"GGCTTT";5;3;7;6;5;26
"GGGGTT";7;5;-1;3;12;26
"GGTTCA";7;2;9;7;1;26
"GTCATC";2;5;1;24;-6;26
"GTCCTT";-9;4;1;23;7;26
"GTGAAG";3;9;4;6;4;26
"GTTATT";-7;6;8;20;-1;26
"GTTCCA";-7;3;3;24;3;26
"TAAAAT";8;5;2;-3;14;26
"TAGACG";8;10;7;-8;9;26
"TAGAGT";10;9;-2;-7;16;26
"TATTGG";5;6;18;-3;0;26
"TCACAG";2;3;5;3;13;26
"TCATGC";16;7;0;3;0;26
"TCCTTA";4;15;9;0;-2;26
"TCGCGG";4;7;1;-1;15;26
"TCGGTA";6;17;1;-3;5;26
"TCTGTC";7;5;5;13;-4;26
"TGATGG";13;6;9;-10;8;26
"TGCATT";7;5;2;-1;13;26
"TGCCCA";7;2;-3;3;17;26
"TGCTCG";10;4;9;-2;5;26
"TGTACA";9;4;4;0;9;26
"TGTGTG";4;4;14;0;4;26
"TTACGG";-1;7;3;7;10;26
"TTAGTA";1;17;3;5;0;26
"AAAATA";0;9;13;5;0;27
"AAATAG";6;5;19;-4;1;27
"AAGTGG";8;9;15;-8;3;27
"ACACTT";-5;3;6;12;11;27
"ACCTTC";8;6;10;11;-8;27
"ACGGTC";10;8;2;8;-1;27
"ACTCAA";-2;0;8;13;8;27
"AGCCCC";11;-7;-2;14;11;27
"AGCTTG";5;5;19;-2;0;27
"AGGACA";12;7;1;-5;12;27
"AGGGTG";7;7;11;-5;7;27
"AGTACC";13;-5;5;11;3;27
"AGTTGA";9;3;12;0;3;27
"ATAGTC";5;8;4;16;-6;27
"ATCCTG";-9;6;13;15;2;27
"ATTATG";-7;8;20;12;-6;27
"ATTCCT";-6;1;5;17;10;27
"ATTCGA";-5;4;6;17;5;27
"CAAATC";8;4;6;11;-2;27
"CAATTT";3;9;12;0;3;27
"CATTAA";6;6;14;1;0;27
"CCGCAA";5;7;-3;3;15;27
"CCTCAC";6;-5;1;19;6;27
"CGATAA";14;6;5;-6;8;27
"CGGACC";20;2;-6;1;10;27
"CGGTGA";16;10;1;-10;10;27
"CGTCAG";3;-6;10;6;14;27
"CGTTGC";17;-2;5;6;1;27
"CTACAA";0;7;-1;11;10;27
"CTGATG";0;15;9;2;1;27
"CTGCCT";1;8;-6;7;17;27
"CTGCGA";2;11;-5;7;12;27
"CTTCGC";3;-1;-1;23;3;27
"GAACGC";6;-5;-2;22;6;27
"GACCTA";-6;3;7;19;4;27
"GAGAAT";7;4;0;3;13;27
"GATATA";-4;5;14;16;-4;27
"GATTAG";2;1;20;7;-3;27
"GCATAC";13;2;2;13;-3;27
"GCGCAG";1;2;3;9;12;27
"GCGTGC";15;6;-2;9;-1;27
"GCTCTT";-9;-1;7;23;7;27
"GGAATA";4;5;5;9;4;27
"GGATAG";10;1;11;0;5;27
"GGGTGG";12;5;7;-4;7;27
"GTACAG";-4;2;5;17;7;27
"GTATGC";10;6;0;17;-6;27
"GTCTTA";-2;14;9;14;-8;27
"GTGCGG";-2;6;1;13;9;27
"GTGGTA";0;16;1;11;-1;27
"GTTGTC";1;4;5;27;-10;27
"TAACCG";1;3;8;3;12;27
"TAACGT";3;2;-1;4;19;27
"TAAGAC";16;3;-1;4;5;27
"TACCAG";2;1;8;3;13;27
"TACTGC";16;5;3;3;0;27
"TAGGGC";18;7;-5;0;7;27
"TATAAG";4;3;15;0;5;27
"TCAAAC";15;4;-3;6;5;27
"TCATAT";10;9;3;-5;10;27
"TCGAGC";17;8;-7;2;7;27
"TCGTCG";10;14;8;-10;5;27
"TCGTGT";12;13;-1;-9;12;27
"TGAAAG";12;3;6;-7;13;27
"TGCGTC";15;3;-1;6;4;27
"TGCTCT";12;4;1;-2;12;27
"TGGAGG";14;7;2;-11;15;27
"TTAAGC";12;8;-5;10;2;27
"TTATCG";5;14;10;-2;0;27
"TTATGT";7;13;1;-1;7;27
"TTCATA";0;16;4;7;0;27
"TTCTAG";6;12;10;-2;1;27
"TTCTCA";5;15;3;5;-1;27
"TTGGAG";8;14;2;-5;8;27
"TTTGTT";-2;11;6;9;3;27
"AACCTT";-5;1;9;12;11;28
"AAGAAG";7;6;12;-5;8;28
"AATATT";-3;3;16;9;3;28
"AATCCA";-3;0;11;13;7;28
"ACATTA";2;13;14;3;-4;28
"ACTCTG";-9;1;19;15;2;28
"AGAATT";5;3;7;2;11;28
"AGACCA";5;0;2;6;15;28
"AGCCAA";6;-2;2;6;16;28
"AGTAAA";8;0;9;3;8;28
"ATCATC";4;7;5;18;-6;28
"ATCTTT";-1;12;11;7;-1;28
"ATGGTT";1;14;3;4;6;28
"ATTTCA";1;11;13;8;-5;28
"CAGATT";4;10;5;-1;10;28
"CAGCCA";4;7;0;3;14;28
"CATCCC";5;-5;4;19;5;28
"CATTTG";-1;7;25;3;-6;28
"CCATTC";10;8;7;9;-6;28
"CCGCTG";-2;8;8;5;9;28
"CGACCC";13;-5;-5;12;13;28
"CGATTG";7;7;16;-4;2;28
"CGCCAC";14;-7;-5;12;14;28
"CGGAAA";15;7;-2;-7;15;28
"CGTAAC";16;-5;2;9;6;28
"CGTTAT";11;0;8;-2;11;28
"CTACTG";-7;8;10;13;4;28
"CTGTCA";8;18;2;-2;2;28
"CTTCAT";-3;1;2;15;13;28
"CTTTCC";9;6;6;14;-7;28
"GAACAT";0;-3;1;14;16;28
"GAATCC";12;2;5;13;-4;28
"GACTAC";13;0;5;13;-3;28
"GAGCCG";0;2;6;9;11;28
"GAGCGT";2;1;-3;10;18;28
"GAGGAC";15;2;-3;10;4;28
"GCGAAC";14;3;-5;12;4;28
"GCGTAT";9;8;1;1;9;28
"GCTTTA";-2;9;15;14;-8;28
"GGCATC";10;-2;1;17;2;28
"GGCCTT";-1;-3;1;16;15;28
"GGGAAG";11;2;4;-1;12;28
"GGTATT";1;-1;8;13;7;28
"GGTCCA";1;-4;3;17;11;28
"GTAAAC";9;3;-3;20;-1;28
"GTATAT";4;8;3;9;4;28
"GTGAGC";11;7;-7;16;1;28
"GTGTCG";4;13;8;4;-1;28
"GTGTGT";6;12;-1;5;6;28
"TAAACC";14;4;0;6;4;28
"TAATCT";9;9;6;-5;9;28
"TAATGA";10;12;7;-5;4;28
"TACAAC";15;2;0;6;5;28
"TACTAT";10;7;6;-5;10;28
"TAGGAT";12;9;-2;-8;17;28
"TATCGG";-1;0;12;7;10;28
"TATGTA";1;10;12;5;0;28
"TCACGC";10;1;-6;13;10;28
"TCCCTA";-2;9;3;10;8;28
"TCGAAT";11;10;-4;-6;17;28
"TCTATA";0;11;10;7;0;28
"TCTTAG";6;7;16;-2;1;28
"TGACGG";7;0;3;0;18;28
"TGAGTA";9;10;3;-2;8;28
"TTAAAT";6;10;-2;2;12;28
"TTGACG";6;15;3;-3;7;28
"TTGAGT";8;14;-6;-2;14;28
"TTTTGG";3;11;14;2;-2;28
"AAACAG";0;-1;13;6;11;29
"AAATGC";14;3;8;6;-2;29
"AACTTA";2;11;17;3;-4;29
"AAGCGG";2;3;9;2;13;29
"AAGGTA";4;13;9;0;3;29
"AATGTC";5;1;13;16;-6;29
"ACCCTC";2;0;4;21;2;29
"ACGATA";3;14;7;2;3;29
"ACGTAG";9;10;13;-7;4;29
"ACTATC";4;2;11;18;-6;29
"ACTTTT";-1;7;17;7;-1;29
"AGAGTC";13;1;4;9;2;29
"AGCCTG";-1;-1;13;8;10;29
"AGTATG";1;1;20;5;2;29
"AGTCCT";2;-6;5;10;18;29
"AGTCGA";3;-3;6;10;13;29
"AGTTCT";8;0;11;2;8;29
"ATAATA";-2;14;9;10;-2;29
"ATATAG";4;10;15;1;-1;29
"ATGTGG";6;14;11;-3;1;29
"CAACTT";-3;3;6;10;13;29
"CACTTC";10;6;10;9;-6;29
"CAGGTC";12;8;2;6;1;29
"CATCAA";0;0;8;11;10;29
"CCGATC";11;9;0;8;1;29
"CCGTTT";6;14;6;-3;6;29
"CGACAA";8;0;-1;4;18;29
"CGGATG";8;8;9;-5;9;29
"CGGCCT";9;1;-6;0;25;29
"CGGCGA";10;4;-5;0;20;29
"CGTCGC";11;-8;-1;16;11;29
"CTAATC";6;9;2;16;-4;29
"CTATTT";1;14;8;5;1;29
"CTTTAA";4;11;10;6;-2;29
"GAATAA";7;7;9;5;1;29
"GAGACC";13;3;-2;12;3;29
"GAGTCT";8;8;4;1;8;29
"GAGTGA";9;11;5;1;3;29
"GATCAG";-4;-5;14;17;7;29
"GATTGC";10;-1;9;17;-6;29
"GCACAC";7;-4;-4;23;7;29
"GCGCGC";9;0;-8;19;9;29
"GGACAG";4;-5;5;10;15;29
"GGATGC";18;-1;0;10;2;29
"GGCTTA";6;7;9;7;0;29
"GGGCGG";6;-1;1;6;17;29
"GGGGTA";8;9;1;4;7;29
"GGTGTC";9;-3;5;20;-2;29
"GTACGC";4;0;-6;27;4;29
"GTCCTA";-8;8;3;24;2;29
"GTGAAT";5;9;-4;8;11;29
"GTTATA";-6;10;10;21;-6;29
"GTTTAG";0;6;16;12;-5;29
"TAAAAA";9;9;4;-2;9;29
"TACCGC";10;-1;-3;13;10;29
"TAGACT";10;10;-1;-6;16;29
"TAGAGA";11;13;0;-6;11;29
"TATAGC";12;1;4;10;2;29
"TATTCG";5;7;19;-2;0;29
"TATTGT";7;6;10;-1;7;29
"TCACAT";4;3;-3;5;20;29
"TCATCC";16;8;1;4;0;29
"TCCTAC";17;6;1;4;1;29
"TCGCCG";4;8;2;0;15;29
"TCGCGT";6;7;-7;1;22;29
"TCGGAC";19;8;-7;1;8;29
"TGAAGC";20;1;-5;3;10;29
"TGATCG";13;7;10;-9;8;29
"TGATGT";15;6;1;-8;15;29
"TGCATA";8;9;4;0;8;29
"TGCTAG";14;5;10;-9;9;29
"TGCTCA";13;8;3;-2;7;29
"TGGGAG";16;7;2;-12;16;29
"TGTGTT";6;4;6;2;11;29
"TTACCG";-1;8;4;8;10;29
"TTACGT";1;7;-5;9;17;29
"TTAGAC";14;8;-5;9;3;29
"TTCCAG";0;6;4;8;11;29
"TTCTGC";14;10;-1;8;-2;29
"TTGGGC";16;12;-9;5;5;29
"TTTAAG";2;8;11;5;3;29
"AAAAAC";13;0;5;9;3;30
"AAATAT";8;5;11;-2;8;30
"AAGAGC";15;4;1;5;5;30
"AAGTCG";8;10;16;-7;3;30
"AAGTGT";10;9;7;-6;10;30
"ACACTA";-4;7;8;13;6;30
"AGCATC";12;0;5;11;2;30
"AGCTTT";7;5;11;0;7;30
"AGGGTT";9;7;3;-3;14;30
"AGTTCA";9;4;13;1;3;30
"ATCCTT";-7;6;5;17;9;30
"ATGAAG";5;11;8;0;6;30
"ATTATT";-5;8;12;14;1;30
"ATTCCA";-5;5;7;18;5;30
"CAATTA";4;13;14;1;-2;30
"CATCTG";-7;1;19;13;4;30
"CCACTC";4;2;1;19;4;30
"CGACTG";1;1;10;6;12;30
"CGGTCA";16;11;2;-9;10;30
"CGTCAT";5;-6;2;8;21;30
"CGTTCC";17;-1;6;7;1;30
"CTGATT";2;15;1;4;8;30
"CTGCCA";2;12;-4;8;12;30
"CTTCCC";3;0;0;24;3;30
"CTTTTG";-3;12;21;8;-8;30
"GAACCC";6;-4;-1;23;6;30
"GAATTG";0;8;20;7;-5;30
"GACCAC";7;-6;-1;23;7;30
"GAGAAA";8;8;2;4;8;30
"GATAAC";9;-4;6;20;-1;30
"GATTAT";4;1;12;9;4;30
"GCGCAT";3;2;-5;11;19;30
"GCGTCC";15;7;-1;10;-1;30
"GCTCTA";-8;3;9;24;2;30
"GGAAAC";17;-4;-3;13;7;30
"GGATAT";12;1;3;2;12;30
"GGGAGC";19;0;-7;9;9;30
"GGGTCG";12;6;8;-3;7;30
"GGGTGT";14;5;-1;-2;14;30
"GTACAT";-2;2;-3;19;14;30
"GTATCC";10;7;1;18;-6;30
"GTCTAC";11;5;1;18;-5;30
"GTGCCG";-2;7;2;14;9;30
"GTGCGT";0;6;-7;15;16;30
"GTGGAC";13;7;-7;15;2;30
"TAAATG";2;10;15;0;3;30
"TAACCT";3;3;0;5;19;30
"TAACGA";4;6;1;5;14;30
"TACCAT";4;1;0;5;20;30
"TACTCC";16;6;4;4;0;30
"TAGGCC";18;8;-4;1;7;30
"TATAAT";6;3;7;2;12;30
"TCATAA";11;13;5;-4;5;30
"TCGACC";17;9;-6;3;7;30
"TCGTCT";12;14;0;-8;12;30
"TCGTGA";13;17;1;-8;7;30
"TCTCAG";0;1;10;8;11;30
"TCTTGC";14;5;5;8;-2;30
"TGAAAT";14;3;-2;-5;20;30
"TGGACG";14;8;3;-10;15;30
"TGGAGT";16;7;-6;-9;22;30
"TGTTGG";11;4;14;-5;6;30
"TTAACC";12;9;-4;11;2;30
"TTATCT";7;14;2;0;7;30
"TTATGA";8;17;3;0;2;30
"TTCAAC";13;7;-4;11;3;30
"TTCTAT";8;12;2;0;8;30
"TTGGAT";10;14;-6;-3;15;30
"TTTCGG";-3;5;8;12;8;30
"TTTGTA";-1;15;8;10;-2;30
"AAACGC";8;-3;2;16;8;31
"AACCTA";-4;5;11;13;6;31
"AAGAAT";9;6;4;-3;15;31
"AATATA";-2;7;18;10;-2;31
"AATTAG";4;3;24;1;-1;31
"ACATAC";15;4;6;7;-1;31
"ACGCAG";3;4;7;3;14;31
"ACGTGC";17;8;2;3;1;31
"ACTCTT";-7;1;11;17;9;31
"AGAATA";6;7;9;3;6;31
"AGATAG";12;3;15;-6;7;31
"AGGTGG";14;7;11;-10;9;31
"ATACAG";-2;4;9;11;9;31
"ATATGC";12;8;4;11;-4;31
"ATCTTA";0;16;13;8;-6;31
"ATGCGG";0;8;5;7;11;31
"ATGGTA";2;18;5;5;1;31
"ATTGTC";3;6;9;21;-8;31
"CACCTC";4;0;4;19;4;31
"CAGATA";5;14;7;0;5;31
"CAGTAG";11;10;13;-9;6;31
"CATATC";6;2;11;16;-4;31
"CATTTT";1;7;17;5;1;31
"CCGCTT";0;8;0;7;16;31
"CGAATC";14;2;2;9;4;31
"CGATTT";9;7;8;-2;9;31
"CGTTAA";12;4;10;-1;6;31
"CTACTT";-5;8;2;15;11;31
"CTCTTC";8;11;6;14;-8;31
"CTGGTC";10;13;-2;11;-1;31
"CTTCAA";-2;5;4;16;8;31
"GAACAA";1;1;3;15;11;31
"GAGATG";1;9;13;6;2;31
"GAGCCT";2;2;-2;11;18;31
"GAGCGA";3;5;-1;11;13;31
"GATCGC";4;-7;3;27;4;31
"GCGTAA";10;12;3;2;4;31
"GCTTAC";11;0;7;18;-5;31
"GGACGC";12;-7;-6;20;12;31
"GGCCTA";0;1;3;17;10;31
"GGGAAT";13;2;-4;1;19;31
"GGTATA";2;3;10;14;2;31
"GGTTAG";8;-1;16;5;3;31
"GTATAA";5;12;5;10;-1;31
"GTGACC";11;8;-6;17;1;31
"GTGTCT";6;13;0;6;6;31
"GTGTGA";7;16;1;6;1;31
"GTTCAG";-6;0;10;22;5;31
"GTTTGC";8;4;5;22;-8;31
"TAATCA";10;13;8;-4;4;31
"TACTAA";11;11;8;-4;5;31
"TAGGAA";13;13;0;-7;12;31
"TATCCG";-1;1;13;8;10;31
"TATCGT";1;0;4;9;17;31
"TATGAC";14;1;4;9;3;31
"TCACCC";10;2;-5;14;10;31
"TCATTG";4;14;16;-2;-1;31
"TCCCAC";11;0;-5;14;11;31
"TCGAAA";12;14;-2;-5;12;31
"TCTAAC";13;2;2;11;3;31
"TCTTAT";8;7;8;0;8;31
"TGACCG";7;1;4;1;18;31
"TGACGT";9;0;-5;2;25;31
"TGAGAC";22;1;-5;2;11;31
"TGCCAG";8;-1;4;1;19;31
"TGCTGC";22;3;-1;1;6;31
"TGGGGC";24;5;-9;-2;13;31
"TGTAAG";10;1;11;-2;11;31
"TTAAAA";7;14;0;3;7;31
"TTCCGC";8;4;-7;18;8;31
"TTGACT";8;15;-5;-1;14;31
"TTGAGA";9;18;-4;-1;9;31
"TTTAGC";10;6;0;15;0;31
"TTTTCG";3;12;15;3;-2;31
"TTTTGT";5;11;6;4;5;31
"AAACAT";2;-1;5;8;18;32
"AAATCC";14;4;9;7;-2;32
"AACTAC";15;2;9;7;-1;32
"AAGCCG";2;4;10;3;13;32
"AAGCGT";4;3;1;4;20;32
"AAGGAC";17;4;1;4;6;32
"ACGAAC";16;5;-1;6;6;32
"ACGTAT";11;10;5;-5;11;32
"ACTTTA";0;11;19;8;-6;32
"AGCCTT";1;-1;5;10;17;32
"AGGAAG";13;4;8;-7;14;32
"AGTATT";3;1;12;7;9;32
"AGTCCA";3;-2;7;11;13;32
"ATAAAC";11;5;1;14;1;32
"ATATAT";6;10;7;3;6;32
"ATGAGC";13;9;-3;10;3;32
"ATGTCG";6;15;12;-2;1;32
"ATGTGT";8;14;3;-1;8;32
"CAACTA";-2;7;8;11;8;32
"CCGTTA";7;18;8;-2;1;32
"CCTTTC";8;6;12;14;-8;32
"CGGATT";10;8;1;-3;16;32
"CGGCCA";10;5;-4;1;20;32
"CGGTCT";15;7;0;-5;15;32
"CGTCCC";11;-7;0;17;11;32
"CGTTTG";5;5;21;1;0;32
"CTATTA";2;18;10;6;-4;32
"CTTCTG";-9;6;15;18;2;32
"GAACTG";-6;2;14;17;5;32
"GAGTCA";9;12;6;2;3;32
"GATCAT";-2;-5;6;19;14;32
"GATTCC";10;0;10;18;-6;32
"GCGCCC";9;1;-7;20;9;32
"GCGTTG";3;13;14;4;-2;32
"GGACAT";6;-5;-3;12;22;32
"GGATCC";18;0;1;11;2;32
"GGCTAC";19;-2;1;11;3;32
"GGGCCG";6;0;2;7;17;32
"GGGCGT";8;-1;-7;8;24;32
"GGGGAC";21;0;-7;8;10;32
"GTACCC";4;1;-5;28;4;32
"GTATTG";-2;13;16;12;-7;32
"GTCCAC";5;-1;-5;28;5;32
"GTGAAA";6;13;-2;9;6;32
"GTTAAC";7;1;2;25;-3;32
"GTTTAT";2;6;8;14;2;32
"TACCCC";10;0;-2;14;10;32
"TACTTG";4;12;19;-2;-1;32
"TAGACA";11;14;1;-5;11;32
"TAGGTG";6;14;11;-5;6;32
"TATACC";12;2;5;11;2;32
"TATTCT";7;7;11;0;7;32
"TATTGA";8;10;12;0;2;32
"TCACAA";5;7;-1;6;15;32
"TCGATG";5;15;9;-3;6;32
"TCGCCT";6;8;-6;2;22;32
"TCGCGA";7;11;-5;2;17;32
"TCTCGC";8;-1;-1;18;8;32
"TGAACC";20;2;-4;4;10;32
"TGATGA";16;10;3;-7;10;32
"TGCAAC";21;0;-4;4;11;32
"TGCTAT";16;5;2;-7;16;32
"TGGGAT";18;7;-6;-10;23;32
"TGTCGG";5;-2;8;5;16;32
"TGTGTA";7;8;8;3;6;32
"TTAATG";0;15;11;5;1;32
"TTACCT";1;8;-4;10;17;32
"TTACGA";2;11;-3;10;12;32
"TTCCAT";2;6;-4;10;18;32
"TTCTCC";14;11;0;9;-2;32
"TTGGCC";16;13;-8;6;5;32
"TTTAAT";4;8;3;7;10;32
"AAATAA";9;9;13;-1;3;33
"AAGACC";15;5;2;6;5;33
"AAGTCT";10;10;8;-5;10;33
"AAGTGA";11;13;9;-5;5;33
"AATCAG";-2;-3;18;11;9;33
"AATTGC";12;1;13;11;-4;33
"ACACAC";9;-2;0;17;9;33
"ACGCGC";11;2;-4;13;11;33
"AGACAG";6;-3;9;4;17;33
"AGATGC";20;1;4;4;4;33
"AGCTTA";8;9;13;1;2;33
"AGGCGG";8;1;5;0;19;33
"AGGGTA";10;11;5;-2;9;33
"AGTGTC";11;-1;9;14;0;33
"ATACGC";6;2;-2;21;6;33
"ATCCTA";-6;10;7;18;4;33
"ATGAAT";7;11;0;2;13;33
"ATTATA";-4;12;14;15;-4;33
"ATTTAG";2;8;20;6;-3;33
"CAATAC";17;4;6;5;1;33
"CAGCAG";5;4;7;1;16;33
"CAGTGC";19;8;2;1;3;33
"CATCTT";-5;1;11;15;11;33
"CGACTT";3;1;2;8;19;33
"CGCTTC";16;4;6;7;0;33
"CGGGTC";18;6;-2;4;7;33
"CGTCAA";6;-2;4;9;16;33
"CTCCTC";2;5;0;24;2;33
"CTGATA";3;19;3;5;3;33
"CTGTAG";9;15;9;-4;4;33
"CTTATC";4;7;7;21;-6;33
"CTTTTT";-1;12;13;10;-1;33
"GAAATC";7;3;6;20;-3;33
"GAATTT";2;8;12;9;2;33
"GATTAA";5;5;14;10;-1;33
"GCGCAA";4;6;-3;12;14;33
"GCTCAC";5;-6;1;28;5;33
"GGATAA";13;5;5;3;7;33
"GGGACC";19;1;-6;10;9;33
"GGGTCT";14;6;0;-1;14;33
"GGGTGA";15;9;1;-1;9;33
"GGTCAG";2;-7;10;15;13;33
"GGTTGC";16;-3;5;15;0;33
"GTACAA";-1;6;-1;20;9;33
"GTGATG";-1;14;9;11;0;33
"GTGCCT";0;7;-6;16;16;33
"GTGCGA";1;10;-5;16;11;33
"GTTCGC";2;-2;-1;32;2;33
"TAAATT";4;10;7;2;10;33
"TAACCA";4;7;2;6;14;33
"TACCAA";5;5;2;6;15;33
"TATAAA";7;7;9;3;7;33
"TCACTG";-2;8;10;8;9;33
"TCGTCA";13;18;2;-7;7;33
"TCTCAT";2;1;2;10;18;33
"TCTTCC";14;6;6;9;-2;33
"TGAAAA";15;7;0;-4;15;33
"TGCCGC";16;-3;-7;11;16;33
"TGGACT";16;8;-5;-8;22;33
"TGGAGA";17;11;-4;-8;17;33
"TGTAGC";18;-1;0;8;8;33
"TGTTCG";11;5;15;-4;6;33
"TGTTGT";13;4;6;-3;13;33
"TTATCA";8;18;4;1;2;33
"TTCTAA";9;16;4;1;3;33
"TTGGAA";11;18;-4;-2;10;33
"TTTCCG";-3;6;9;13;8;33
"TTTCGT";-1;5;0;14;15;33
"TTTGAC";12;6;0;14;1;33
"AAACCC";8;-2;3;17;8;34
"AAATTG";2;10;24;1;-3;34
"AACCAC";9;-4;3;17;9;34
"AAGAAA";10;10;6;-2;10;34
"AATAAC";11;-2;10;14;1;34
"AATTAT";6;3;16;3;6;34
"ACGCAT";5;4;-1;5;21;34
"ACGTCC";17;9;3;4;1;34
"ACTCTA";-6;5;13;18;4;34
"AGAAAC";19;-2;1;7;9;34
"AGATAT";14;3;7;-4;14;34
"AGGAGC";21;2;-3;3;11;34
"AGGTCG";14;8;12;-9;9;34
"AGGTGT";16;7;3;-8;16;34
"ATACAT";0;4;1;13;16;34
"ATATCC";12;9;5;12;-4;34
"ATCTAC";13;7;5;12;-3;34
"ATGCCG";0;9;6;8;11;34
"ATGCGT";2;8;-3;9;18;34
"ATGGAC";15;9;-3;9;4;34
"CAGAAC";18;5;-1;4;8;34
"CAGTAT";13;10;5;-7;13;34
"CATTTA";2;11;19;6;-4;34
"CCGCTA";1;12;2;8;11;34
"CCTCTC";2;0;6;24;2;34
"CGATTA";10;11;10;-1;4;34
"CGTCTG";-1;-1;15;11;10;34
"CTACTA";-4;12;4;16;6;34
"GAGATT";3;9;5;8;9;34
"GAGCCA";3;6;0;12;13;34
"GATCCC";4;-6;4;28;4;34
"GATTTG";-2;6;25;12;-7;34
"GCATTC";9;7;7;18;-7;34
"GCGCTG";-3;7;8;14;8;34
"GGACCC";12;-6;-5;21;12;34
"GGATTG";6;6;16;5;1;34
"GGCCAC";13;-8;-5;21;13;34
"GGGAAA";14;6;-2;2;14;34
"GGTAAC";15;-6;2;18;5;34
"GGTTAT";10;-1;8;7;10;34
"GTACTG";-8;7;10;22;3;34
"GTGTCA";7;17;2;7;1;34
"GTTCAT";-4;0;2;24;12;34
"GTTTCC";8;5;6;23;-8;34
"TAAGTC";12;8;4;9;1;34
"TACCTG";-2;6;13;8;9;34
"TATATG";0;8;20;5;1;34
"TATCCT";1;1;5;10;17;34
"TATCGA";2;4;6;10;12;34
"TCAATC";11;9;2;11;1;34
"TCATTT";6;14;8;0;6;34
"TCTTAA";9;11;10;1;3;34
"TGAATG";8;8;11;-2;9;34
"TGACCT";9;1;-4;3;25;34
"TGACGA";10;4;-3;3;20;34
"TGCCAT";10;-1;-4;3;26;34
"TGCTCC";22;4;0;2;6;34
"TGGGCC";24;6;-8;-1;13;34
"TGTAAT";12;1;3;0;18;34
"TTCCCC";8;5;-6;19;8;34
"TTCTTG";2;17;15;3;-3;34
"TTGACA";9;19;-3;0;9;34
"TTGGTG";4;19;7;0;4;34
"TTTACC";10;7;1;16;0;34
"TTTTCT";5;12;7;5;5;34
"TTTTGA";6;15;8;5;0;34
"AAACAA";3;3;7;9;13;35
"AAGATG";3;11;17;0;4;35
"AAGCCT";4;4;2;5;20;35
"AAGCGA";5;7;3;5;15;35
"AATCGC";6;-5;7;21;6;35
"ACGTAA";12;14;7;-4;6;35
"ACTTAC";13;2;11;12;-3;35
"AGACGC";14;-5;-2;14;14;35
"AGCCTA";2;3;7;11;12;35
"AGGAAT";15;4;0;-5;21;35
"AGTATA";4;5;14;8;4;35
"AGTTAG";10;1;20;-1;5;35
"ATATAA";7;14;9;4;1;35
"ATGACC";13;10;-2;11;3;35
"ATGTCT";8;15;4;0;8;35
"ATGTGA";9;18;5;0;3;35
"ATTCAG";-4;2;14;16;7;35
"ATTTGC";10;6;9;16;-6;35
"CAACAC";11;-2;0;15;11;35
"CAGCGC";13;2;-4;11;13;35
"CCGTAC";20;9;0;2;4;35
"CGCCTC";10;-2;0;17;10;35
"CGGATA";11;12;3;-2;11;35
"CGGTAG";17;8;9;-11;12;35
"CGTATC";12;0;7;14;2;35
"CGTTTT";7;5;13;3;7;35
"CTATAC";15;9;2;10;-1;35
"CTGCAG";3;9;3;6;14;35
"CTGTGC";17;13;-2;6;1;35
"CTTCTT";-7;6;7;20;9;35
"GAACTT";-4;2;6;19;12;35
"GACTTC";9;5;10;18;-7;35
"GAGGTC";11;7;2;15;0;35
"GATCAA";-1;-1;8;20;9;35
"GCGATC";10;8;0;17;0;35
"GCGTTT";5;13;6;6;5;35
"GGACAA";7;-1;-1;13;17;35
"GGGATG";7;7;9;4;8;35
"GGGCCT";8;0;-6;9;24;35
"GGGCGA";9;3;-5;9;19;35
"GGTCGC";10;-9;-1;25;10;35
"GTAATC";5;8;2;25;-5;35
"GTATTT";0;13;8;14;0;35
"GTTTAA";3;10;10;15;-3;35
"TACATC";11;7;5;11;1;35
"TACTTT";6;12;11;0;6;35
"TAGGTT";8;14;3;-3;13;35
"TATTCA";8;11;13;1;2;35
"TCGATT";7;15;1;-1;13;35
"TCGCCA";7;12;-4;3;17;35
"TCTCCC";8;0;0;19;8;35
"TCTTTG";2;12;21;3;-3;35
"TGATCA";16;11;4;-6;10;35
"TGCTAA";17;9;4;-6;11;35
"TGGGAA";19;11;-4;-9;18;35
"TGTCCG";5;-1;9;6;16;35
"TGTCGT";7;-2;0;7;23;35
"TGTGAC";20;-1;0;7;9;35
"TTAATT";2;15;3;7;8;35
"TTACCA";2;12;-2;11;12;35
"TTCCAA";3;10;-2;11;13;35
"TTTAAA";5;12;5;8;5;35
"AAACTG";-4;4;18;11;7;36
"AAGTCA";11;14;10;-4;5;36
"AATCAT";0;-3;10;13;16;36
"AATTCC";12;2;14;12;-4;36
"ACGCCC";11;3;-3;14;11;36
"ACGTTG";5;15;18;-2;0;36
"AGACAT";8;-3;1;6;24;36
"AGATCC";20;2;5;5;4;36
"AGCTAC";21;0;5;5;5;36
"AGGCCG";8;2;6;1;19;36
"AGGCGT";10;1;-3;2;26;36
"AGGGAC";23;2;-3;2;12;36
"ATACCC";6;3;-1;22;6;36
"ATATTG";0;15;20;6;-5;36
"ATCCAC";7;1;-1;22;7;36
"ATGAAA";8;15;2;3;8;36
"ATTAAC";9;3;6;19;-1;36
"ATTTAT";4;8;12;8;4;36
"CAGCAT";7;4;-1;3;23;36
"CAGTCC";19;9;3;2;3;36
"CATCTA";-4;5;13;16;6;36
"CGACTA";4;5;4;9;14;36
"CTGAAC";16;10;-5;9;6;36
"CTGTAT";11;15;1;-2;11;36
"CTTTTA";0;16;15;11;-6;36
"GAATTA";3;12;14;10;-3;36
"GATCTG";-8;0;19;22;3;36
"GCACTC";3;1;1;28;3;36
"GGACTG";0;0;10;15;11;36
"GGGTCA";15;10;2;0;9;36
"GGTCAT";4;-7;2;17;20;36
"GGTTCC";16;-2;6;16;0;36
"GTGATT";1;14;1;13;7;36
"GTGCCA";1;11;-4;17;11;36
"GTTCCC";2;-1;0;33;2;36
"GTTTTG";-4;11;21;17;-9;36
"TAAATA";5;14;9;3;5;36
"TAATAG";11;10;15;-6;6;36
"TAGTGG";13;14;11;-10;8;36
"TCACTT";0;8;2;10;16;36
"TCCTTC";13;11;6;9;-3;36
"TCGGTC";15;13;-2;6;4;36
"TCTCAA";3;5;4;11;13;36
"TGATCT";15;7;2;-3;15;36
"TGCCCC";16;-2;-6;12;16;36
"TGCTTG";10;10;15;-4;5;36
"TGGACA";17;12;-3;-7;17;36
"TGGGTG";12;12;7;-7;12;36
"TGTACC";18;0;1;9;8;36
"TGTTGA";14;8;8;-2;8;36
"TTAGTC";10;13;0;14;-1;36
"TTCCTG";-4;11;9;13;7;36
"TTTATG";-2;13;16;10;-1;36
"TTTCCT";-1;6;1;15;15;36
"TTTCGA";0;9;2;15;10;36
"AAAATC";9;5;10;14;-1;37
"AAATTT";4;10;16;3;4;37
"AATTAA";7;7;18;4;1;37
"ACGCAA";6;8;1;6;16;37
"ACTCAC";7;-4;5;22;7;37
"AGATAA";15;7;9;-3;9;37
"AGGACC";21;3;-2;4;11;37
"AGGTGA";17;11;5;-7;11;37
"AGTCAG";4;-5;14;9;15;37
"AGTTGC";18;-1;9;9;2;37
"ATACAA";1;8;3;14;11;37
"ATGATG";1;16;13;5;2;37
"ATGCCT";2;9;-2;10;18;37
"ATGCGA";3;12;-1;10;13;37
"ATTCGC";4;0;3;26;4;37
"CAGTAA";14;14;7;-6;8;37
"CATTAC";15;2;11;10;-1;37
"CCGCAC";14;3;-6;12;14;37
"CGATAC";23;2;2;3;7;37
"CGGCAG";11;2;3;-1;22;37
"CGGTGC";25;6;-2;-1;9;37
"CGTCTT";1;-1;7;13;17;37
"CTACAC";9;3;-4;20;9;37
"CTGCGC";11;7;-8;16;11;37
"GACCTC";3;-1;4;28;3;37
"GAGATA";4;13;7;9;4;37
"GAGTAG";10;9;13;0;5;37
"GATATC";5;1;11;25;-5;37
"GATTTT";0;6;17;14;0;37
"GCGCTT";-1;7;0;16;15;37
"GGAATC";13;1;2;18;3;37
"GGATTT";8;6;8;7;8;37
"GGTTAA";11;3;10;8;5;37
"GTACTT";-6;7;2;24;10;37
"GTCTTC";7;10;6;23;-9;37
"GTGGTC";9;12;-2;20;-2;37
"GTTCAA";-3;4;4;25;7;37
"TACCTT";0;6;5;10;16;37
"TAGAAG";12;11;8;-7;13;37
"TATATT";2;8;12;7;8;37
"TATCCA";2;5;7;11;12;37
"TCATTA";7;18;10;1;1;37
"TCTCTG";-4;6;15;13;7;37
"TGAATT";10;8;3;0;16;37
"TGACCA";10;5;-2;4;20;37
"TGCCAA";11;3;-2;4;21;37
"TGTAAA";13;5;5;1;13;37
"TTCATC";9;12;1;16;-1;37
"TTCTTT";4;17;7;5;4;37
"TTGGTT";6;19;-1;2;11;37
"TTTTCA";6;16;9;6;0;37
"AAGATT";5;11;9;2;11;38
"AAGCCA";5;8;4;6;15;38
"AATCCC";6;-4;8;22;6;38
"AATTTG";0;8;29;6;-5;38
"ACATTC";11;9;11;12;-5;38
"ACGCTG";-1;9;12;8;10;38
"AGACCC";14;-4;-1;15;14;38
"AGATTG";8;8;20;-1;3;38
"AGCCAC";15;-6;-1;15;15;38
"AGGAAA";16;8;2;-4;16;38
"AGTAAC";17;-4;6;12;7;38
"AGTTAT";12;1;12;1;12;38
"ATACTG";-6;9;14;16;5;38
"ATGTCA";9;19;6;1;3;38
"ATTCAT";-2;2;6;18;14;38
"ATTTCC";10;7;10;17;-6;38
"CAGCCC";13;3;-3;12;13;38
"CAGTTG";7;15;18;-4;2;38
"CGGAAC";24;3;-5;2;14;38
"CGGTAT";19;8;1;-9;19;38
"CGTTTA";8;9;15;4;2;38
"CTGCAT";5;9;-5;8;21;38
"CTGTCC";17;14;-1;7;1;38
"CTTCTA";-6;10;9;21;4;38
"GAACTA";-3;6;8;20;7;38
"GCGTTA";6;17;8;7;0;38
"GCTTTC";7;5;12;23;-9;38
"GGGATT";9;7;1;6;15;38
"GGGCCA";9;4;-4;10;19;38
"GGTCCC";10;-8;0;26;10;38
"GGTTTG";4;4;21;10;-1;38
"GTATTA";1;17;10;15;-5;38
"GTTCTG";-10;5;15;27;1;38
"TAACAG";5;4;9;4;16;38
"TAATGC";19;8;4;4;3;38
"TACTTA";7;16;13;1;1;38
"TAGCGG";7;8;5;0;18;38
"TAGGTA";9;18;5;-2;8;38
"TATGTC";10;6;9;14;-1;38
"TCCCTC";7;5;0;19;7;38
"TCGATA";8;19;3;0;8;38
"TCGTAG";14;15;9;-9;9;38
"TCTATC";9;7;7;16;-1;38
"TCTTTT";4;12;13;5;4;38
"TGAGTC";18;6;0;7;7;38
"TGCCTG";4;4;9;6;15;38
"TGTATG";6;6;16;3;7;38
"TGTCCT";7;-1;1;8;23;38
"TGTCGA";8;2;2;8;18;38
"TTAATA";3;19;5;8;3;38
"TTATAG";9;15;11;-1;4;38
"TTGTGG";11;19;7;-5;6;38
"AAACTT";-2;4;10;13;14;39
"AACTTC";11;7;14;12;-5;39
"AAGGTC";13;9;6;9;2;39
"AATCAA";1;1;12;14;11;39
"ACGATC";12;10;4;11;2;39
"ACGTTT";7;15;10;0;7;39
"AGACAA";9;1;3;7;19;39
"AGGATG";9;9;13;-2;10;39
"AGGCCT";10;2;-2;3;26;39
"AGGCGA";11;5;-1;3;21;39
"AGGTCT";16;8;4;-5;16;39
"AGTCGC";12;-7;3;19;12;39
"ATAATC";7;10;6;19;-3;39
"ATATTT";2;15;12;8;2;39
"ATTTAA";5;12;14;9;-1;39
"CAGCAA";8;8;1;4;18;39
"CATCAC";9;-4;5;20;9;39
"CGACAC";17;-4;-4;13;17;39
"CGGCGC";19;0;-8;9;19;39
"CTGTAA";12;19;3;-1;6;39
"CTTTAC";13;7;7;15;-3;39
"GAATAC";16;3;6;14;0;39
"GAGCAG";4;3;7;10;15;39
"GAGTGC";18;7;2;10;2;39
"GATCTT";-6;0;11;24;10;39
"GGACTT";2;0;2;17;18;39
"GGCTTC";15;3;6;16;-1;39
"GGGGTC";17;5;-2;13;6;39
"GGTCAA";5;-3;4;18;15;39
"GTCCTC";1;4;0;33;1;39
"GTGATA";2;18;3;14;2;39
"GTGTAG";8;14;9;5;3;39
"GTTATC";3;6;7;30;-7;39
"GTTTTT";-2;11;13;19;-2;39
"TAAAAC";18;5;1;7;8;39
"TAATAT";13;10;7;-4;13;39
"TAGAGC";20;9;-3;3;10;39
"TAGTCG";13;15;12;-9;8;39
"TAGTGT";15;14;3;-8;15;39
"TCACTA";1;12;4;11;11;39
"TGCATC";17;5;1;9;7;39
"TGCTTT";12;10;7;-2;12;39
"TGGGTT";14;12;-1;-5;19;39
"TGTTCA";14;9;9;-1;8;39
"TTCCTT";-2;11;1;15;14;39
"TTGAAG";10;16;4;-2;11;39
"TTTATT";0;13;8;12;6;39
"TTTCCA";0;10;3;16;10;39
"AAATTA";5;14;18;4;-1;40
"AATCTG";-6;2;23;16;5;40
"ACACTC";5;3;5;22;5;40
"AGACTG";2;2;14;9;13;40
"AGGTCA";17;12;6;-6;11;40
"AGTCAT";6;-5;6;11;22;40
"AGTTCC";18;0;10;10;2;40
"ATGATT";3;16;5;7;9;40
"ATGCCA";3;13;0;11;13;40
"ATTCCC";4;1;4;27;4;40
"ATTTTG";-2;13;25;11;-7;40
"CAATTC";13;9;11;10;-3;40
"CAGCTG";1;9;12;6;12;40
"CGGCAT";13;2;-5;1;29;40
"CGGTCC";25;7;-1;0;9;40
"CGTCTA";2;3;9;14;12;40
"CTGCCC";11;8;-7;17;11;40
"CTGTTG";5;20;14;1;0;40
"GAGAAC";17;4;-1;13;7;40
"GAGTAT";12;9;5;2;12;40
"GATTTA";1;10;19;15;-5;40
"GCGCTA";0;11;2;17;10;40
"GCTCTC";1;-1;6;33;1;40
"GGATTA";9;10;10;8;3;40
"GGTCTG";-2;-2;15;20;9;40
"GTACTA";-5;11;4;25;5;40
"TAACGC";13;2;-2;14;13;40
"TACCTA";1;10;7;11;11;40
"TAGAAT";14;11;0;-5;20;40
"TATATA";3;12;14;8;3;40
"TATTAG";9;8;20;-1;4;40
"TCATAC";20;9;2;5;4;40
"TCGCAG";8;9;3;1;19;40
"TCGTGC";22;13;-2;1;6;40
"TCTCTT";-2;6;7;15;14;40
"TGAATA";11;12;5;1;11;40
"TGATAG";17;8;11;-8;12;40
"TGGTGG";19;12;7;-12;14;40
"TGTTCT";13;5;7;2;13;40
"TTACAG";3;9;5;9;14;40
"TTATGC";17;13;0;9;1;40
"TTCTTA";5;21;9;6;-1;40
"TTGCGG";5;13;1;5;16;40
"TTGGTA";7;23;1;3;6;40
"TTTGTC";8;11;5;19;-3;40
"AACCTC";5;1;8;22;5;41
"AAGATA";6;15;11;3;6;41
"AAGTAG";12;11;17;-6;7;41
"AATATC";7;3;15;19;-3;41
"AATTTT";2;8;21;8;2;41
"ACGCTT";1;9;4;10;17;41
"AGAATC";15;3;6;12;5;41
"AGATTT";10;8;12;1;10;41
"AGTTAA";13;5;14;2;7;41
"ATACTT";-4;9;6;18;12;41
"ATCTTC";9;12;10;17;-7;41
"ATGGTC";11;14;2;14;0;41
"ATTCAA";-1;6;8;19;9;41
"CAGATC";14;10;4;9;4;41
"CAGTTT";9;15;10;-2;9;41
"CGGTAA";20;12;3;-8;14;41
"CGTTAC";21;0;7;8;5;41
"CTGCAA";6;13;-3;9;16;41
"CTTCAC";7;1;1;25;7;41
"GAACAC";10;-3;0;24;10;41
"GAGCGC";12;1;-4;20;12;41
"GCGTAC";19;8;0;11;3;41
"GGCCTC";9;-3;0;26;9;41
"GGGATA";10;11;3;7;10;41
"GGGTAG";16;7;9;-2;11;41
"GGTATC";11;-1;7;23;1;41
"GGTTTT";6;4;13;12;6;41
"GTATAC";14;8;2;19;-2;41
"GTGCAG";2;8;3;15;13;41
"GTGTGC";16;12;-2;15;0;41
"GTTCTT";-8;5;7;29;8;41
"TAACAT";7;4;1;6;23;41
"TAATCC";19;9;5;5;3;41
"TACTAC";20;7;5;5;4;41
"TAGCCG";7;9;6;1;18;41
"TAGCGT";9;8;-3;2;25;41
"TAGGAC";22;9;-3;2;11;41
"TCGAAC";21;10;-5;4;11;41
"TCGTAT";16;15;1;-7;16;41
"TCTTTA";5;16;15;6;-1;41
"TGCCTT";6;4;1;8;22;41
"TGGAAG";18;9;4;-9;19;41
"TGTATT";8;6;8;5;14;41
"TGTCCA";8;3;3;9;18;41
"TTAAAC";16;10;-3;12;6;41
"TTATAT";11;15;3;1;11;41
"TTGAGC";18;14;-7;8;8;41
"TTGTCG";11;20;8;-4;6;41
"TTGTGT";13;19;-1;-3;13;41
"AAACTA";-1;8;12;14;9;42
"ACGTTA";8;19;12;1;2;42
"ACTTTC";9;7;16;17;-7;42
"AGGATT";11;9;5;0;17;42
"AGGCCA";11;6;0;4;21;42
"AGTCCC";12;-6;4;20;12;42
"AGTTTG";6;6;25;4;1;42
"ATATTA";3;19;14;9;-3;42
"ATTCTG";-8;7;19;21;3;42
"CAACTC";7;3;5;20;7;42
"CCGTTC";16;14;5;7;0;42
"CGGCCC";19;1;-7;10;19;42
"CGGTTG";13;13;14;-6;8;42
"CTATTC";11;14;7;15;-5;42
"CTGCTG";-1;14;8;11;10;42
"GAGCAT";6;3;-1;12;22;42
"GAGTCC";18;8;3;11;2;42
"GATCTA";-5;4;13;25;5;42
"GGACTA";3;4;4;18;13;42
"GTGAAC";15;9;-5;18;5;42
"GTGTAT";10;14;1;7;10;42
"GTTTTA";-1;15;15;20;-7;42
"TAATAA";14;14;9;-3;8;42
"TAGACC";20;10;-2;4;10;42
"TAGTCT";15;15;4;-7;15;42
"TAGTGA";16;18;5;-7;10;42
"TATCAG";3;2;14;9;14;42
"TATTGC";17;6;9;9;1;42
"TCACAC";14;3;-4;15;14;42
"TCGCGC";16;7;-8;11;16;42
"TGACAG";11;2;5;2;22;42
"TGATGC";25;6;0;2;9;42
"TGCTTA";13;14;9;-1;7;42
"TGGCGG";13;6;1;-2;24;42
"TGGGTA";15;16;1;-4;14;42
"TGTGTC";16;4;5;12;5;42
"TTACGC";11;7;-6;19;11;42
"TTCCTA";-1;15;3;16;9;42
"TTGAAT";12;16;-4;0;18;42
"TTTATA";1;17;10;13;1;42
"TTTTAG";7;13;16;4;2;42
"AAATAC";18;5;10;8;2;43
"AAGCAG";6;5;11;4;17;43
"AAGTGC";20;9;6;4;4;43
"AATCTT";-4;2;15;18;12;43
"AGACTT";4;2;6;11;20;43
"AGCTTC";17;5;10;10;1;43
"AGGGTC";19;7;2;7;8;43
"AGTCAA";7;-1;8;12;17;43
"ATCCTC";3;6;4;27;3;43
"ATGATA";4;20;7;8;4;43
"ATGTAG";10;16;13;-1;5;43
"ATTATC";5;8;11;24;-5;43
"ATTTTT";0;13;17;13;0;43
"CAGCTT";3;9;4;8;19;43
"CGGCAA";14;6;-3;2;24;43
"CGTCAC";15;-6;1;18;15;43
"CTGATC";12;15;0;14;2;43
"CTGTTT";7;20;6;3;7;43
"GAGTAA";13;13;7;3;7;43
"GATTAC";14;1;11;19;-2;43
"GCGCAC";13;2;-6;21;13;43
"GGATAC";22;1;2;12;6;43
"GGGCAG";10;1;3;8;21;43
"GGGTGC";24;5;-2;8;8;43
"GGTCTT";0;-2;7;22;16;43
"GTACAC";8;2;-4;29;8;43
"GTGCGC";10;6;-8;25;10;43
"TAACCC";13;3;-1;15;13;43
"TAATTG";7;15;20;-1;2;43
"TACCAC";14;1;-1;15;14;43
"TAGAAA";15;15;2;-4;15;43
"TATAAC";16;3;6;12;6;43
"TATTAT";11;8;12;1;11;43
"TCGCAT";10;9;-5;3;26;43
"TCGTCC";22;14;-1;2;6;43
"TCTCTA";-1;10;9;16;9;43
"TGAAAC";24;3;-3;5;14;43
"TGATAT";19;8;3;-6;19;43
"TGGAGC";26;7;-7;1;16;43
"TGGTCG";19;13;8;-11;14;43
"TGGTGT";21;12;-1;-10;21;43
"TTACAT";5;9;-3;11;21;43
"TTATCC";17;14;1;10;1;43
"TTCTAC";18;12;1;10;2;43
"TTGCCG";5;14;2;6;16;43
"TTGCGT";7;13;-7;7;23;43
"TTGGAC";20;14;-7;7;9;43
"AAGAAC";19;6;3;7;9;44
"AAGTAT";14;11;9;-4;14;44
"AATTTA";3;12;23;9;-3;44
"ACGCTA";2;13;6;11;12;44
"ACTCTC";3;1;10;27;3;44
"AGATTA";11;12;14;2;5;44
"AGTCTG";0;0;19;14;11;44
"ATACTA";-3;13;8;19;7;44
"CAGTTA";10;19;12;-1;4;44
"CATTTC";11;7;16;15;-5;44
"CCGCTC";10;8;-1;17;10;44
"CGATTC";19;7;7;8;3;44
"CGGCTG";7;7;8;4;18;44
"CTACTC";5;8;1;25;5;44
"GAGCCC";12;2;-3;21;12;44
"GAGTTG";6;14;18;5;1;44
"GGGAAC";23;2;-5;11;13;44
"GGGTAT";18;7;1;0;18;44
"GGTTTA";7;8;15;13;1;44
"GTGCAT";4;8;-5;17;20;44
"GTGTCC";16;13;-1;16;0;44
"GTTCTA";-7;9;9;30;3;44
"TAACAA";8;8;3;7;18;44
"TAGATG";8;16;13;-2;9;44
"TAGCCT";9;9;-2;3;25;44
"TAGCGA";10;12;-1;3;20;44
"TATCGC";11;0;3;19;11;44
"TCGTAA";17;19;3;-6;11;44
"TCTTAC";18;7;7;10;2;44
"TGACGC";19;0;-6;12;19;44
"TGCCTA";7;8;3;9;17;44
"TGGAAT";20;9;-4;-7;26;44
"TGTATA";9;10;10;6;9;44
"TGTTAG";15;6;16;-3;10;44
"TTATAA";12;19;5;2;6;44
"TTGACC";18;15;-6;9;8;44
"TTGTCT";13;20;0;-2;13;44
"TTGTGA";14;23;1;-2;8;44
"TTTCAG";1;7;10;14;12;44
"TTTTGC";15;11;5;14;-1;44
"AAACAC";12;-1;4;18;12;45
"AAGCGC";14;3;0;14;14;45
"ACGTAC";21;10;4;5;5;45
"AGCCTC";11;-1;4;20;11;45
"AGGATA";12;13;7;1;12;45
"AGGTAG";18;9;13;-8;13;45
"AGTATC";13;1;11;17;3;45
"AGTTTT";8;6;17;6;8;45
"ATATAC";16;10;6;13;0;45
"ATGCAG";4;10;7;9;15;45
"ATGTGC";18;14;2;9;2;45
"ATTCTT";-6;7;11;23;10;45
"CGGATC";20;8;0;7;10;45
"CGGTTT";15;13;6;-4;15;45
"CTGCTT";1;14;0;13;17;45
"GAGCAA";7;7;1;13;17;45
"GATCAC";8;-5;5;29;8;45
"GGACAC";16;-5;-4;22;16;45
"GGGCGC";18;-1;-8;18;18;45
"GTGTAA";11;18;3;8;5;45
"GTTTAC";12;6;7;24;-4;45
"TAACTG";1;9;14;9;12;45
"TAGTCA";16;19;6;-6;10;45
"TATCAT";5;2;6;11;21;45
"TATTCC";17;7;10;10;1;45
"TCGCCC";16;8;-7;12;16;45
"TCGTTG";10;20;14;-4;5;45
"TGACAT";13;2;-3;4;29;45
"TGATCC";25;7;1;3;9;45
"TGCTAC";26;5;1;3;10;45
"TGGCCG";13;7;2;-1;24;45
"TGGCGT";15;6;-7;0;31;45
"TGGGAC";28;7;-7;0;17;45
"TTACCC";11;8;-5;20;11;45
"TTATTG";5;20;16;4;0;45
"TTCCAC";12;6;-5;20;12;45
"TTGAAA";13;20;-2;1;13;45
"TTTAAC";14;8;2;17;4;45
"TTTTAT";9;13;8;6;9;45
"AAGCAT";8;5;3;6;24;46
"AAGTCC";20;10;7;5;4;46
"AATCTA";-3;6;17;19;7;46
"AGACTA";5;6;8;12;15;46
"ATGAAC";17;11;-1;12;7;46
"ATGTAT";12;16;5;1;12;46
"ATTTTA";1;17;19;14;-5;46
"CAGCTA";4;13;6;9;14;46
"CATCTC";5;1;10;25;5;46
"CGACTC";13;1;1;18;13;46
"CTGTTA";8;24;8;4;2;46
"CTTTTC";9;12;12;20;-7;46
"GAATTC";12;8;11;19;-4;46
"GAGCTG";0;8;12;15;11;46
"GGGCAT";12;1;-5;10;28;46
"GGGTCC";24;6;-1;9;8;46
"GGTCTA";1;2;9;23;11;46
"GTGCCC";10;7;-7;26;10;46
"GTGTTG";4;19;14;10;-1;46
"TAAATC";14;10;6;12;4;46
"TAATTT";9;15;12;1;9;46
"TATTAA";12;12;14;2;6;46
"TCGCAA";11;13;-3;4;21;46
"TCTCAC";12;1;1;20;12;46
"TGATAA";20;12;5;-5;14;46
"TGGACC";26;8;-6;2;16;46
"TGGTGA";22;16;1;-9;16;46
"TGTCAG";9;0;10;7;20;46
"TGTTGC";23;4;5;7;7;46
"TTACAA";6;13;-1;12;16;46
"TTGATG";6;21;9;3;7;46
"TTGCCT";7;14;-6;8;23;46
"TTGCGA";8;17;-5;8;18;46
"TTTCGC";9;5;-1;24;9;46
"AAGTAA";15;15;11;-3;9;47
"AATTAC";16;3;15;13;0;47
"ACGCAC";15;4;-2;15;15;47
"AGATAC";24;3;6;6;8;47
"AGGCAG";12;3;7;2;23;47
"AGGTGC";26;7;2;2;10;47
"AGTCTT";2;0;11;16;18;47
"ATACAC";10;4;0;23;10;47
"ATGCGC";12;8;-4;19;12;47
"CAGTAC";23;10;4;3;7;47
"CGGCTT";9;7;0;6;25;47
"GAGATC";13;9;4;18;3;47
"GAGTTT";8;14;10;7;8;47
"GGGTAA";19;11;3;1;13;47
"GGTTAC";20;-1;7;17;4;47
"GTGCAA";5;12;-3;18;15;47
"GTTCAC";6;0;1;34;6;47
"TAGATT";10;16;5;0;16;47
"TAGCCA";10;13;0;4;20;47
"TATCCC";11;1;4;20;11;47
"TATTTG";5;13;25;4;0;47
"TCATTC";16;14;7;10;0;47
"TCGCTG";4;14;8;6;15;47
"TGACCC";19;1;-5;13;19;47
"TGATTG";13;13;16;-3;8;47
"TGCCAC";20;-1;-5;13;20;47
"TGGAAA";21;13;-2;-6;21;47
"TGTAAC";22;1;2;10;12;47
"TGTTAT";17;6;8;-1;17;47
"TTACTG";-1;14;10;14;10;47
"TTGTCA";14;24;2;-1;8;47
"TTTCAT";3;7;2;16;19;47
"TTTTCC";15;12;6;15;-1;47
"AAGCCC";14;4;1;15;14;48
"AAGTTG";8;16;22;-1;3;48
"AGGAAC";25;4;-1;5;15;48
"AGGTAT";20;9;5;-6;20;48
"AGTTTA";9;10;19;7;3;48
"ATGCAT";6;10;-1;11;22;48
"ATGTCC";18;15;3;10;2;48
"ATTCTA";-5;11;13;24;5;48
"CGGTTA";16;17;8;-3;10;48
"CGTTTC";17;5;12;13;1;48
"CTGCTA";2;18;2;14;12;48
"CTTCTC";3;6;6;30;3;48
"GAACTC";6;2;5;29;6;48
"GCGTTC";15;13;5;16;-1;48
"GGGCCC";18;0;-7;19;18;48
"GGGTTG";12;12;14;3;7;48
"GTATTC";10;13;7;24;-6;48
"GTGCTG";-2;13;8;20;9;48
"TAACTT";3;9;6;11;19;48
"TACTTC";16;12;10;10;0;48
"TAGGTC";18;14;2;7;7;48
"TATCAA";6;6;8;12;16;48
"TCGATC";17;15;0;9;7;48
"TCGTTT";12;20;6;-2;12;48
"TGACAA";14;6;-1;5;24;48
"TGGATG";14;14;9;-4;15;48
"TGGCCT";15;7;-6;1;31;48
"TGGCGA";16;10;-5;1;26;48
"TGTCGC";17;-2;-1;17;17;48
"TTAATC";12;15;2;17;2;48
"TTATTT";7;20;8;6;7;48
"TTTTAA";10;17;10;7;4;48
"AAGCAA";9;9;5;7;19;49
"AATCAC";10;-3;9;23;10;49
"AGACAC";18;-3;0;16;18;49
"AGGCGC";20;1;-4;12;20;49
"ATGTAA";13;20;7;2;7;49
"ATTTAC";14;8;11;18;-2;49
"CAGCAC";17;4;-2;13;17;49
"CTGTAC";21;15;0;8;5;49
"GAGCTT";2;8;4;17;18;49
"GGGCAA";13;5;-3;11;23;49
"GGTCAC";14;-7;1;27;14;49
"GTGATC";11;14;0;23;1;49
"GTGTTT";6;19;6;12;6;49
"TAATTA";10;19;14;2;4;49
"TATCTG";-1;7;19;14;10;49
"TCACTC";10;8;1;20;10;49
"TGACTG";7;7;10;7;18;49
"TGGTCA";22;17;2;-8;16;49
"TGTCAT";11;0;2;9;27;49
"TGTTCC";23;5;6;8;7;49
"TTGATT";8;21;1;5;14;49
"TTGCCA";8;18;-4;9;18;49
"TTTCCC";9;6;0;25;9;49
"TTTTTG";3;18;21;9;-2;49
"AAATTC";14;10;15;13;-2;50
"AAGCTG";2;10;16;9;13;50
"AGGCAT";14;3;-1;4;30;50
"AGGTCC";26;8;3;3;10;50
"AGTCTA";3;4;13;17;13;50
"ATGCCC";12;9;-3;20;12;50
"ATGTTG";6;21;18;4;1;50
"CGGCTA";10;11;2;7;20;50
"CGTCTC";11;-1;6;23;11;50
"GAGTTA";9;18;12;8;3;50
"GATTTC";10;6;16;24;-6;50
"GCGCTC";9;7;-1;26;9;50
"GGATTC";18;6;7;17;2;50
"GGGCTG";6;6;8;13;17;50
"GTACTC";4;7;1;34;4;50
"TACCTC";10;6;4;20;10;50
"TAGATA";11;20;7;1;11;50
"TAGTAG";17;16;13;-8;12;50
"TATATC";12;8;11;17;2;50
"TATTTT";7;13;17;6;7;50
"TCGCTT";6;14;0;8;22;50
"TGAATC";20;8;2;10;10;50
"TGATTT";15;13;8;-1;15;50
"TGGTCT";21;13;0;-5;21;50
"TGTTAA";18;10;10;0;12;50
"TTACTT";1;14;2;16;17;50
"TTCTTC";14;17;6;15;-2;50
"TTGGTC";16;19;-2;12;5;50
"TTTCAA";4;11;4;17;14;50
"AAGATC";15;11;8;12;5;51
"AAGTTT";10;16;14;1;10;51
"AGGTAA";21;13;7;-5;15;51
"AGTTAC";22;1;11;11;6;51
"ATGCAA";7;14;1;12;17;51
"ATTCAC";8;2;5;28;8;51
"CGGTAC";29;8;0;1;13;51
"CTGCAC";15;9;-6;18;15;51
"GGGATC";19;7;0;16;9;51
"GGGTTT";14;12;6;5;14;51
"GTGCTT";0;13;0;22;16;51
"TAACTA";4;13;8;12;14;51
"TCGTTA";13;24;8;-1;7;51
"TCTTTC";14;12;12;15;-2;51
"TGGATT";16;14;1;-2;22;51
"TGGCCA";16;11;-4;2;26;51
"TGTCCC";17;-1;0;18;17;51
"TGTTTG";11;11;21;2;6;51
"TTATTA";8;24;10;7;2;51
"TTTCTG";-3;12;15;19;8;51
"AAACTC";8;4;9;23;8;52
"ACGTTC";17;15;9;10;1;52
"AGGCCC";20;2;-3;13;20;52
"AGGTTG";14;14;18;-3;9;52
"ATATTC";12;15;11;18;-4;52
"ATGCTG";0;15;12;14;11;52
"GAGCTA";3;12;6;18;13;52
"GATCTC";4;0;10;34;4;52
"GGACTC";12;0;1;27;12;52
"GTGTTA";7;23;8;13;1;52
"GTTTTC";8;11;12;29;-8;52
"TAATAC";23;10;6;6;7;52
"TAGCAG";11;10;7;2;22;52
"TAGTGC";25;14;2;2;9;52
"TATCTT";1;7;11;16;17;52
"TGACTT";9;7;2;9;25;52
"TGCTTC";22;10;6;8;6;52
"TGGGTC";24;12;-2;5;13;52
"TGTCAA";12;4;4;10;22;52
"TTCCTC";8;11;0;25;8;52
"TTGATA";9;25;3;6;9;52
"TTGTAG";15;21;9;-3;10;52
"TTTATC";10;13;7;22;0;52
"TTTTTT";5;18;13;11;5;52
"AAGCTT";4;10;8;11;20;53
"AGGCAA";15;7;1;5;25;53
"AGTCAC";16;-5;5;21;16;53
"ATGATC";13;16;4;17;3;53
"ATGTTT";8;21;10;6;8;53
"CGGCAC";23;2;-6;11;23;53
"GAGTAC";22;9;4;12;6;53
"GGGCTT";8;6;0;15;24;53
"TAGAAC";24;11;-1;5;14;53
"TAGTAT";19;16;5;-6;19;53
"TATTTA";8;17;19;7;2;53
"TCGCTA";7;18;2;9;17;53
"TCTCTC";8;6;6;25;8;53
"TGATTA";16;17;10;0;10;53
"TGTCTG";5;5;15;12;16;53
"TTACTA";2;18;4;17;12;53
"AAGTTA";11;20;16;2;5;54
"AATTTC";12;8;20;18;-4;54
"ACGCTC";11;9;3;20;11;54
"AGATTC";20;8;11;11;4;54
"AGGCTG";8;8;12;7;19;54
"ATACTC";6;9;5;28;6;54
"CAGTTC";19;15;9;8;3;54
"GGGTTA";15;16;8;6;9;54
"GGTTTC";16;4;12;22;0;54
"GTGCTA";1;17;2;23;11;54
"GTTCTC";2;5;6;39;2;54
"TAACAC";17;4;0;16;17;54
"TAGCGC";19;8;-4;12;19;54
"TCGTAC";26;15;0;3;10;54
"TGCCTC";16;4;0;18;16;54
"TGGATA";17;18;3;-1;17;54
"TGGTAG";23;14;9;-10;18;54
"TGTATC";18;6;7;15;8;54
"TGTTTT";13;11;13;4;13;54
"TTATAC";21;15;2;11;5;54
"TTGCAG";9;15;3;7;20;54
"TTGTGC";23;19;-2;7;7;54
"TTTCTT";-1;12;7;21;15;54
"AGGATC";21;9;4;10;11;55
"AGGTTT";16;14;10;-1;16;55
"ATGCTT";2;15;4;16;18;55
"GAGCAC";16;3;-2;22;16;55
"GTGTAC";20;14;0;17;4;55
"TAGCAT";13;10;-1;4;29;55
"TAGTCC";25;15;3;3;9;55
"TATCTA";2;11;13;17;12;55
"TGACTA";10;11;4;10;20;55
"TTGAAC";22;16;-5;10;12;55
"TTGTAT";17;21;1;-1;17;55
"TTTTTA";6;22;15;12;0;55
"AAGCTA";5;14;10;12;15;56
"AATCTC";6;2;14;28;6;56
"AGACTC";14;2;5;21;14;56
"ATGTTA";9;25;12;7;3;56
"ATTTTC";10;13;16;23;-6;56
"CAGCTC";13;9;3;18;13;56
"CTGTTC";17;20;5;13;1;56
"GGGCTA";9;10;2;16;19;56
"GGTCTC";10;-2;6;32;10;56
"TAGTAA";20;20;7;-5;14;56
"TATTAC";21;8;11;11;5;56
"TCGCAC";20;9;-6;13;20;56
"TGATAC";29;8;2;4;13;56
"TGGCAG";17;8;3;0;28;56
"TGGTGC";31;12;-2;0;15;56
"TGTCTT";7;5;7;14;23;56
"TTACAC";15;9;-4;21;15;56
"TTGCGC";17;13;-8;17;17;56
"AAGTAC";24;11;8;6;8;57
"AGGCTT";10;8;4;9;26;57
"GGGTAC";28;7;0;10;12;57
"GTGCAC";14;8;-6;27;14;57
"TAGCCC";19;9;-3;13;19;57
"TAGTTG";13;21;18;-3;8;57
"TGGAAC";30;9;-5;3;20;57
"TGGTAT";25;14;1;-8;25;57
"TGTTTA";14;15;15;5;8;57
"TTGCAT";11;15;-5;9;27;57
"TTGTCC";23;20;-1;8;7;57
"TTTCTA";0;16;9;22;10;57
"AGGTTA";17;18;12;0;11;58
"AGTTTC";18;6;16;16;2;58
"ATGCTA";3;19;6;17;13;58
"ATTCTC";4;7;10;33;4;58
"CGGTTC";25;13;5;6;9;58
"CTGCTC";11;14;-1;23;11;58
"TAGCAA";14;14;1;5;24;58
"TATCAC";15;2;5;21;15;58
"TGACAC";23;2;-4;14;23;58
"TGGCGC";25;6;-8;10;25;58
"TTGTAA";18;25;3;0;12;58
"TTTTAC";19;13;7;16;3;58
"AAGCAC";18;5;2;16;18;59
"ATGTAC";22;16;4;11;6;59
"GGGCAC";22;1;-6;20;22;59
"TAATTC";19;15;11;11;3;59
"TAGCTG";7;15;12;7;18;59
"TGGCAT";19;8;-5;2;35;59
"TGGTCC";31;13;-1;1;15;59
"TGTCTA";8;9;9;15;18;59
"TTGCCC";17;14;-7;18;17;59
"TTGTTG";11;26;14;2;6;59
"AGGCTA";11;12;6;10;21;60
"AGTCTC";12;0;10;26;12;60
"CGGCTC";19;7;-1;16;19;60
"GAGTTC";18;14;9;17;2;60
"TAGATC";20;16;4;10;10;60
"TAGTTT";15;21;10;-1;15;60
"TGGTAA";26;18;3;-7;20;60
"TGTTAC";27;6;7;9;11;60
"TTGCAA";12;19;-3;10;22;60
"TTTCAC";13;7;1;26;13;60
"AGGTAC";30;9;4;4;14;61
"ATGCAC";16;10;-2;21;16;61
"TAACTC";13;9;5;21;13;61
"TCGTTC";22;20;5;8;6;61
"TGGCCC";25;7;-7;11;25;61
"TGGTTG";19;19;14;-5;14;61
"TTATTC";17;20;7;16;1;61
"TTGCTG";5;20;8;12;16;61
"GAGCTC";12;8;3;27;12;62
"GTGTTC";16;19;5;22;0;62
"TAGCTT";9;15;4;9;25;62
"TGGCAA";20;12;-3;3;30;62
"TGTCAC";21;0;1;19;21;62
"TTGATC";18;21;0;15;8;62
"TTGTTT";13;26;6;4;13;62
"AGGCAC";24;3;-2;14;24;63
"TAGTTA";16;25;12;0;10;63
"TATTTC";17;13;16;16;1;63
"TCGCTC";16;14;-1;18;16;63
"TGATTC";25;13;7;9;9;63
"TGGCTG";13;13;8;5;24;63
"TTACTC";11;14;1;26;11;63
"AAGTTC";20;16;13;11;4;64
"GGGTTC";24;12;5;15;8;64
"GTGCTC";10;13;-1;32;10;64
"TGGATC";26;14;0;8;16;64
"TGGTTT";21;19;6;-3;21;64
"TTGCTT";7;20;0;14;23;64
"TAGCTA";10;19;6;10;20;65
"TATCTC";11;7;10;26;11;65
"TGACTC";19;7;1;19;19;65
"TTGTTA";14;30;8;5;8;65
"TTTTTC";15;18;12;21;-1;65
"AAGCTC";14;10;7;21;14;66
"ATGTTC";18;21;9;16;2;66
"GGGCTC";18;6;-1;25;18;66
"TAGTAC";29;16;4;4;13;66
"TGGCTT";15;13;0;7;31;66
"TGGTTA";22;23;8;-2;16;67
"TGTTTC";23;11;12;14;7;67
"TTGCTA";8;24;2;15;18;67
"TTTCTC";9;12;6;31;9;67
"AGGTTC";26;14;9;9;10;68
"ATGCTC";12;15;3;26;12;68
"TAGCAC";23;10;-2;14;23;68
"TTGTAC";27;21;0;9;11;68
"TGGCTA";16;17;2;8;26;69
"TGTCTC";17;5;6;24;17;69
"AGGCTC";20;8;3;19;20;70
"TGGTAC";35;14;0;2;19;70
"TTGCAC";21;15;-6;19;21;70
"TGGCAC";29;8;-6;12;29;72
"TAGTTC";25;21;9;9;9;73
"TAGCTC";19;15;3;19;19;75
"TTGTTC";23;26;5;14;7;75
"TGGTTC";31;19;5;7;15;77
"TTGCTC";17;20;-1;24;17;77
"TGGCTC";25;13;-1;17;25;79
